phase1_solution_length,phase2_solution_length,solution_length,phase1_move_count,phase2_move_count,move_count,phase1_solve_time,phase2_solve_time,solve_time
12,9,21,4613758,123,4613881,0.372432,0.000008,0.372440
10,11,21,114759,995,115754,0.010194,0.000105,0.010299
11,10,21,204238,1032,205270,0.019377,0.000059,0.019436
12,9,21,27974210,137,27974347,1.795654,0.000008,1.795662
10,11,21,99313,2746,102059,0.006891,0.000176,0.007067
13,8,21,27160064,151,27160215,1.623150,0.000007,1.623157
9,12,21,3450,7040,10490,0.000255,0.000285,0.000540
11,10,21,96948,228,97176,0.007500,0.000009,0.007509
12,8,20,857368,159,857527,0.059221,0.000009,0.059230
11,10,21,1809876,307,1810183,0.127688,0.000028,0.127716
11,10,21,1368074,380,1368454,0.087054,0.000035,0.087089
11,10,21,232009,536,232545,0.015036,0.000021,0.015057
11,10,21,1657835,265,1658100,0.124100,0.000024,0.124124
11,10,21,564757,394,565151,0.046228,0.000015,0.046243
13,7,20,180974032,105,180974137,10.833960,0.000009,10.833968
11,10,21,999630,1283,1000913,0.063929,0.000065,0.063994
12,9,21,11625980,842,11626822,0.721392,0.000069,0.721461
10,11,21,77786,7814,85600,0.006152,0.000376,0.006528
11,10,21,164669,6589,171258,0.012176,0.000380,0.012556
9,12,21,10404,21684,32088,0.000689,0.001132,0.001821
9,12,21,4306,41241,45547,0.000367,0.002508,0.002875
13,8,21,49376687,152,49376839,2.888350,0.000012,2.888362
9,11,20,9396,26421,35817,0.000636,0.001428,0.002064
9,12,21,7429,73865,81294,0.000686,0.003320,0.004006
10,11,21,61677,5392,67069,0.005451,0.000295,0.005746
11,10,21,1259621,2294,1261915,0.081745,0.000109,0.081854
14,7,21,141021306,84,141021390,8.795892,0.000005,8.795897
9,12,21,12577,33526,46103,0.000921,0.001597,0.002518
8,13,21,1675,171831,173506,0.000231,0.007278,0.007509
8,13,21,1731,434967,436698,0.000168,0.021288,0.021456
11,10,21,725388,129,725517,0.047814,0.000010,0.047824
8,13,21,3342,114765,118107,0.000197,0.006187,0.006384
11,10,21,2916571,208,2916779,0.198163,0.000013,0.198176
11,10,21,112537,10924,123461,0.009173,0.000552,0.009725
12,9,21,28448716,213,28448929,1.757632,0.000018,1.757650
13,8,21,10441136,121,10441257,0.647344,0.000007,0.647351
12,9,21,12095257,2232,12097489,0.708435,0.000107,0.708542
8,13,21,392,62428,62820,0.000022,0.003572,0.003594
11,10,21,893421,462,893883,0.063063,0.000031,0.063094
11,10,21,676663,131,676794,0.049314,0.000015,0.049329
10,11,21,161452,3468,164920,0.012640,0.000211,0.012851
9,12,21,2645,41149,43794,0.000217,0.001981,0.002198
13,8,21,175280351,170,175280521,10.647488,0.000010,10.647497
9,12,21,16679,144800,161479,0.001750,0.005176,0.006926
10,11,21,104902,4361,109263,0.008661,0.000332,0.008993
11,10,21,228328,1342,229670,0.018651,0.000087,0.018738
12,9,21,14420409,434,14420843,0.887400,0.000039,0.887439
13,8,21,62556797,109,62556906,4.486589,0.000007,4.486596
10,11,21,22632,1392,24024,0.001607,0.000115,0.001722
11,10,21,2520017,989,2521006,0.163720,0.000084,0.163804
11,10,21,1661153,265,1661418,0.119265,0.000041,0.119306
8,13,21,1153,270319,271472,0.000103,0.009846,0.009949
10,11,21,50457,10890,61347,0.003423,0.000771,0.004194
9,12,21,8319,68096,76415,0.000744,0.004043,0.004787
10,11,21,2265,185,2450,0.000258,0.000010,0.000268
11,9,20,509391,868,510259,0.039355,0.000065,0.039420
11,10,21,107730,2246,109976,0.009362,0.000101,0.009463
12,9,21,9961316,233,9961549,0.647801,0.000022,0.647823
10,11,21,29233,2784,32017,0.001936,0.000095,0.002031
11,10,21,2085604,348,2085952,0.140467,0.000021,0.140488
11,10,21,1147934,301,1148235,0.073213,0.000023,0.073236
11,10,21,2044152,146,2044298,0.135599,0.000009,0.135608
11,9,20,802296,138,802434,0.052412,0.000011,0.052423
10,10,20,144152,453,144605,0.012557,0.000038,0.012595
12,9,21,3161464,377,3161841,0.184459,0.000017,0.184476
13,8,21,180312705,118,180312823,10.960751,0.000006,10.960756
10,11,21,122116,11680,133796,0.009445,0.000697,0.010142
11,9,20,522013,270,522283,0.034347,0.000024,0.034371
10,11,21,30514,5960,36474,0.002502,0.000226,0.002728
10,11,21,89133,11474,100607,0.006400,0.000701,0.007101
10,11,21,53566,1459,55025,0.004717,0.000129,0.004846
10,11,21,86309,3024,89333,0.006245,0.000190,0.006435
11,10,21,760518,3007,763525,0.051940,0.000169,0.052109
8,13,21,4338,18103,22441,0.000337,0.000943,0.001280
11,9,20,340697,643,341340,0.022875,0.000055,0.022930
10,10,20,82551,1385,83936,0.006169,0.000056,0.006225
12,9,21,11807397,277,11807674,0.708994,0.000024,0.709018
12,9,21,6060107,129,6060236,0.383737,0.000009,0.383746
10,11,21,34019,3461,37480,0.002944,0.000246,0.003190
10,11,21,33012,6855,39867,0.002577,0.000440,0.003017
10,11,21,53256,13423,66679,0.003863,0.000646,0.004509
11,10,21,320416,1085,321501,0.025255,0.000060,0.025315
11,10,21,323955,1432,325387,0.024828,0.000102,0.024930
11,10,21,621986,962,622948,0.039894,0.000055,0.039949
12,9,21,3976521,1227,3977748,0.264064,0.000088,0.264152
12,9,21,16435401,530,16435931,1.003254,0.000037,1.003291
10,11,21,126130,1105,127235,0.009092,0.000124,0.009216
11,10,21,466720,539,467259,0.033449,0.000024,0.033473
12,9,21,6667023,323,6667346,0.383728,0.000033,0.383761
10,11,21,95005,2477,97482,0.007158,0.000191,0.007349
12,9,21,18137144,203,18137347,1.120672,0.000015,1.120687
12,9,21,10917707,817,10918524,0.650409,0.000055,0.650464
12,9,21,7341757,132,7341889,0.432356,0.000007,0.432363
12,9,21,2000020,504,2000524,0.135921,0.000038,0.135959
12,9,21,278671,356,279027,0.020664,0.000015,0.020679
10,11,21,36565,3685,40250,0.004145,0.000273,0.004418
12,9,21,2544805,187,2544992,0.172194,0.000016,0.172210
8,13,21,646,21720,22366,0.000064,0.000740,0.000804
12,9,21,1334713,155,1334868,0.081579,0.000010,0.081589
9,12,21,1421,11501,12922,0.000245,0.000427,0.000672
