phase1_solution_length,phase2_solution_length,solution_length,phase1_move_count,phase2_move_count,move_count,phase1_solve_time,phase2_solve_time,solve_time
9,16,25,1800,5383076,5384876,0.000197,0.208067,0.208264
9,14,23,2212,190310,192522,0.000198,0.007144,0.007342
8,15,23,496,2563669,2564165,0.000045,0.096907,0.096952
10,14,24,10144,420988,431132,0.000805,0.015189,0.015994
9,16,25,7188,7585647,7592835,0.000570,0.263391,0.263961
9,15,24,6123,433510,439633,0.000513,0.015034,0.015547
9,14,23,3364,599143,602507,0.000294,0.020627,0.020921
9,15,24,8745,1674082,1682827,0.000702,0.056678,0.057380
10,13,23,17975,23967,41942,0.001290,0.001162,0.002452
10,13,23,35758,46397,82155,0.002274,0.002013,0.004287
10,14,24,51175,4738818,4789993,0.003140,0.172321,0.175461
9,14,23,4705,245095,249800,0.000378,0.008600,0.008978
10,14,24,29344,209830,239174,0.002015,0.008711,0.010726
8,15,23,888,3341016,3341904,0.000079,0.126046,0.126125
10,14,24,77427,254859,332286,0.005160,0.009497,0.014657
9,13,22,7480,25795,33275,0.000574,0.001353,0.001927
10,15,25,53471,672636,726107,0.003803,0.027524,0.031327
10,14,24,14470,1177494,1191964,0.001083,0.039228,0.040311
10,15,25,63587,430106,493693,0.004083,0.016558,0.020641
9,12,21,10404,21684,32088,0.000798,0.000940,0.001738
9,12,21,4306,41241,45547,0.000330,0.001772,0.002102
10,16,26,77063,3845086,3922149,0.005114,0.149741,0.154855
9,11,20,9396,26421,35817,0.000736,0.001015,0.001751
8,15,23,796,1157460,1158256,0.000058,0.042407,0.042465
10,14,24,9916,269044,278960,0.000784,0.010180,0.010964
9,15,24,7886,4739466,4747352,0.000620,0.173058,0.173678
9,15,24,741,1080527,1081268,0.000077,0.043780,0.043857
9,15,24,8176,1113412,1121588,0.000650,0.041564,0.042214
8,14,22,1658,599254,600912,0.000156,0.020992,0.021148
8,13,21,1731,434967,436698,0.000153,0.015712,0.015865
10,15,25,16227,364854,381081,0.001323,0.012994,0.014317
8,13,21,3342,114765,118107,0.000251,0.004619,0.004870
9,13,22,10628,75706,86334,0.000812,0.002957,0.003769
10,15,25,35162,1871288,1906450,0.002542,0.066183,0.068725
9,13,22,6410,78411,84821,0.000542,0.002978,0.003520
10,14,24,45919,1414920,1460839,0.003484,0.053709,0.057193
10,16,26,5056,2875155,2880211,0.000407,0.111915,0.112322
8,13,21,392,62428,62820,0.000040,0.002939,0.002979
10,16,26,12003,3098826,3110829,0.000956,0.122178,0.123134
10,13,23,16254,695,16949,0.001231,0.000059,0.001290
9,16,25,10752,1745904,1756656,0.000739,0.067868,0.068607
9,13,22,2628,197483,200111,0.000207,0.007383,0.007590
10,15,25,8452,2663319,2671771,0.000672,0.094624,0.095296
9,15,24,1981,1297368,1299349,0.000183,0.046497,0.046680
10,12,22,23487,16758,40245,0.001744,0.000726,0.002470
10,14,24,31816,493535,525351,0.002153,0.018626,0.020779
10,14,24,15546,864630,880176,0.001258,0.029877,0.031135
9,15,24,16244,3463433,3479677,0.001179,0.129008,0.130187
10,15,25,9162,415483,424645,0.000731,0.015055,0.015786
9,14,23,7885,213738,221623,0.000619,0.009106,0.009725
9,14,23,3842,1311969,1315811,0.000319,0.043832,0.044151
8,14,22,1136,1904046,1905182,0.000097,0.070416,0.070513
9,15,24,5202,761543,766745,0.000463,0.028601,0.029064
9,12,21,8319,68096,76415,0.000686,0.002669,0.003355
9,14,23,2260,170438,172698,0.000194,0.006693,0.006887
10,14,24,7993,699660,707653,0.000650,0.025267,0.025917
10,14,24,7862,516781,524643,0.000659,0.018344,0.019003
9,15,24,1660,3007888,3009548,0.000154,0.108922,0.109076
9,14,23,29222,352836,382058,0.001947,0.013136,0.015083
9,14,23,7050,167783,174833,0.000534,0.006441,0.006975
10,13,23,12653,214262,226915,0.000947,0.007942,0.008889
9,14,23,3396,221348,224744,0.000241,0.008447,0.008688
10,13,23,24232,4738,28970,0.001825,0.000259,0.002084
8,15,23,689,251287,251976,0.000052,0.009579,0.009631
10,16,26,73608,1402345,1475953,0.004356,0.060216,0.064572
10,15,25,23365,1547221,1570586,0.001790,0.053313,0.055103
10,14,24,13045,248189,261234,0.001020,0.010040,0.011060
10,15,25,6856,2293550,2300406,0.000571,0.083890,0.084461
9,14,23,2390,4065203,4067593,0.000210,0.135313,0.135523
9,14,23,6678,1236153,1242831,0.000525,0.044940,0.045465
10,14,24,15626,620300,635926,0.001243,0.021460,0.022703
9,13,22,6098,216276,222374,0.000488,0.008692,0.009180
10,13,23,23228,14789,38017,0.001909,0.001084,0.002993
8,14,22,4321,169438,173759,0.000323,0.006873,0.007196
10,15,25,45605,5627540,5673145,0.003241,0.235185,0.238426
9,15,24,6864,151700,158564,0.000596,0.006323,0.006919
10,14,24,49831,53697,103528,0.003280,0.002891,0.006171
10,13,23,13345,13507,26852,0.000937,0.000706,0.001643
9,15,24,5591,2415061,2420652,0.000420,0.091605,0.092025
9,14,23,9137,1322872,1332009,0.000685,0.045179,0.045864
10,15,25,20889,332221,353110,0.001509,0.013033,0.014542
10,15,25,14133,2260245,2274378,0.001121,0.079911,0.081032
10,13,23,7977,239703,247680,0.000637,0.008881,0.009518
9,14,23,9824,195949,205773,0.000680,0.007262,0.007942
10,13,23,52408,87247,139655,0.003558,0.003967,0.007525
10,14,24,41909,1657120,1699029,0.002866,0.064472,0.067338
9,13,22,8663,25291,33954,0.000687,0.001358,0.002045
9,14,23,2518,567940,570458,0.000212,0.028141,0.028353
10,13,23,107126,239713,346839,0.007593,0.009633,0.017226
9,15,24,1000,271844,272844,0.000087,0.011170,0.011257
10,14,24,36396,2230143,2266539,0.002589,0.079179,0.081768
10,15,25,23777,601056,624833,0.001619,0.026576,0.028195
10,15,25,13601,1951094,1964695,0.001080,0.070674,0.071754
11,14,25,97419,227878,325297,0.006555,0.008927,0.015482
10,15,25,7132,257094,264226,0.000550,0.009831,0.010381
9,15,24,3090,514313,517403,0.000243,0.020094,0.020337
10,14,24,17680,170036,187716,0.001411,0.007912,0.009323
8,14,22,629,1063829,1064458,0.000068,0.037245,0.037313
10,14,24,9265,3618553,3627818,0.000766,0.135836,0.136602
8,14,22,1125,1263457,1264582,0.000096,0.048133,0.048229
10,13,23,23113,157948,181061,0.001760,0.006740,0.008500
10,13,23,11809,69396,81205,0.000890,0.003331,0.004221
10,15,25,17634,5522833,5540467,0.001310,0.194531,0.195841
10,15,25,26019,1055614,1081633,0.002048,0.043643,0.045691
10,15,25,18750,680632,699382,0.001429,0.026700,0.028129
10,14,24,64000,104801,168801,0.004409,0.004845,0.009254
9,14,23,3036,92504,95540,0.000252,0.004599,0.004851
9,13,22,1446,76774,78220,0.000155,0.003379,0.003534
10,14,24,41894,72063,113957,0.002689,0.003803,0.006492
9,14,23,4295,772660,776955,0.000369,0.030078,0.030447
8,15,23,2842,173314,176156,0.000294,0.007968,0.008262
10,14,24,44884,624687,669571,0.003281,0.025690,0.028971
10,13,23,34161,119444,153605,0.002609,0.005068,0.007677
10,14,24,15468,783131,798599,0.001125,0.032542,0.033667
10,14,24,30605,73720,104325,0.002100,0.003259,0.005359
10,14,24,35503,146183,181686,0.002560,0.006286,0.008846
10,15,25,13075,811800,824875,0.000971,0.030372,0.031343
9,12,21,15357,39744,55101,0.001221,0.001830,0.003051
9,14,23,2197,418886,421083,0.000216,0.017843,0.018059
10,14,24,22562,693807,716369,0.001876,0.027847,0.029723
9,13,22,9896,41314,51210,0.000860,0.001894,0.002754
9,15,24,2103,1619097,1621200,0.000186,0.059822,0.060008
10,14,24,6964,12776,19740,0.000631,0.000974,0.001605
10,14,24,14285,1448620,1462905,0.001106,0.054660,0.055766
10,15,25,20023,1878002,1898025,0.001601,0.070234,0.071835
9,14,23,1694,171326,173020,0.000197,0.006564,0.006761
10,15,25,12190,423442,435632,0.000942,0.016814,0.017756
10,15,25,70911,987449,1058360,0.004374,0.040587,0.044961
10,12,22,31671,12890,44561,0.002424,0.000835,0.003259
7,14,21,577,214380,214957,0.000059,0.008475,0.008534
9,14,23,7161,1941795,1948956,0.000569,0.065963,0.066532
10,15,25,37225,802453,839678,0.002696,0.029999,0.032695
10,15,25,77768,1059454,1137222,0.005105,0.042948,0.048053
10,14,24,16747,559584,576331,0.001393,0.024964,0.026357
10,14,24,26505,101743,128248,0.002066,0.004058,0.006124
9,11,20,3695,4701,8396,0.000301,0.000320,0.000621
9,14,23,1863,9551220,9553083,0.000158,0.306303,0.306461
10,11,21,20659,1671,22330,0.001326,0.000113,0.001439
10,15,25,35782,461245,497027,0.002643,0.018239,0.020882
9,14,23,4098,139017,143115,0.000372,0.005808,0.006180
8,14,22,2599,1349393,1351992,0.000225,0.045891,0.046116
10,15,25,18386,900145,918531,0.001418,0.036936,0.038354
9,12,21,3441,14835,18276,0.000339,0.000776,0.001115
10,13,23,89310,20755,110065,0.005983,0.000995,0.006978
11,15,26,91145,4216145,4307290,0.005306,0.176659,0.181965
10,14,24,7447,135322,142769,0.000723,0.006449,0.007172
9,15,24,1138,1986632,1987770,0.000114,0.087610,0.087724
10,14,24,54616,1704891,1759507,0.003849,0.066332,0.070181
9,14,23,6564,675036,681600,0.000612,0.024195,0.024807
10,13,23,11392,12256,23648,0.000950,0.000638,0.001588
9,14,23,16221,13173,29394,0.001161,0.000996,0.002157
10,13,23,29423,74086,103509,0.002032,0.004170,0.006202
10,14,24,24479,99962,124441,0.001770,0.004644,0.006414
9,13,22,5216,111399,116615,0.000425,0.004514,0.004939
10,14,24,8607,329810,338417,0.000704,0.013237,0.013941
9,13,22,8469,19703,28172,0.000667,0.001125,0.001792
10,16,26,39792,3553006,3592798,0.002728,0.140179,0.142907
10,12,22,72277,36065,108342,0.004585,0.001893,0.006478
9,16,25,7262,4587825,4595087,0.000523,0.169900,0.170423
10,14,24,30851,184609,215460,0.002227,0.007419,0.009646
10,14,24,43187,1864970,1908157,0.003461,0.065469,0.068930
10,12,22,11907,2449,14356,0.001009,0.000201,0.001210
8,15,23,637,948585,949222,0.000076,0.042538,0.042614
9,14,23,2041,977218,979259,0.000224,0.035834,0.036058
10,13,23,17102,147379,164481,0.001392,0.005917,0.007309
10,15,25,24137,896689,920826,0.001765,0.033076,0.034841
9,12,21,3091,105027,108118,0.000329,0.004185,0.004514
10,15,25,8960,796243,805203,0.000713,0.030165,0.030878
10,14,24,44542,355402,399944,0.002572,0.014530,0.017102
9,15,24,12979,466410,479389,0.000987,0.019033,0.020020
11,14,25,92860,1301422,1394282,0.006029,0.045355,0.051384
9,13,22,828,213800,214628,0.000120,0.009008,0.009128
10,14,24,16097,107969,124066,0.001273,0.005546,0.006819
8,14,22,1756,1805692,1807448,0.000169,0.069663,0.069832
10,13,23,39927,279837,319764,0.003050,0.011446,0.014496
8,16,24,248,2308890,2309138,0.000024,0.099567,0.099591
10,15,25,42105,689288,731393,0.003164,0.031726,0.034890
10,15,25,20815,571145,591960,0.001608,0.025515,0.027123
9,14,23,3388,296091,299479,0.000299,0.013068,0.013367
9,14,23,3913,328832,332745,0.000347,0.015277,0.015624
10,15,25,13103,3437408,3450511,0.001029,0.140683,0.141712
10,14,24,14807,197330,212137,0.001189,0.007590,0.008779
9,16,25,9525,1877298,1886823,0.000735,0.084255,0.084990
9,15,24,9667,1086174,1095841,0.000823,0.042609,0.043432
7,15,22,206,682210,682416,0.000019,0.032084,0.032103
9,15,24,2604,516742,519346,0.000263,0.023805,0.024068
9,15,24,1587,1848936,1850523,0.000183,0.071987,0.072170
10,15,25,15304,1953322,1968626,0.001194,0.074561,0.075755
10,14,24,16910,392574,409484,0.001369,0.015425,0.016794
10,15,25,10163,1524947,1535110,0.000854,0.056252,0.057106
10,15,25,47360,1019046,1066406,0.003339,0.045292,0.048631
10,15,25,33571,10981683,11015254,0.002491,0.382430,0.384921
10,15,25,19162,213554,232716,0.001615,0.009319,0.010934
10,15,25,16306,1242725,1259031,0.001171,0.052605,0.053776
9,14,23,6125,100096,106221,0.000581,0.004114,0.004695
10,16,26,21677,3925590,3947267,0.001751,0.164944,0.166695
10,14,24,18269,223549,241818,0.001302,0.009076,0.010378
9,13,22,22471,1085,23556,0.001750,0.000115,0.001865
11,13,24,72600,5174,77774,0.004718,0.000307,0.005025
10,14,24,30123,652942,683065,0.001993,0.024677,0.026670
9,15,24,18495,134803,153298,0.001325,0.005744,0.007069
8,11,19,1524,9193,10717,0.000132,0.000415,0.000547
10,14,24,25737,168500,194237,0.002017,0.006606,0.008623
9,14,23,853,7533795,7534648,0.000075,0.287003,0.287078
9,15,24,10118,2796634,2806752,0.000828,0.113566,0.114394
8,14,22,545,223262,223807,0.000057,0.010013,0.010070
10,10,20,12990,966,13956,0.000993,0.000064,0.001057
10,13,23,20019,158400,178419,0.001387,0.006903,0.008290
10,15,25,37194,4778112,4815306,0.002927,0.204958,0.207885
10,14,24,16428,64976,81404,0.001391,0.003077,0.004468
10,15,25,20077,939665,959742,0.001495,0.045939,0.047434
9,14,23,5750,275675,281425,0.000538,0.015355,0.015893
10,14,24,25060,80962,106022,0.001777,0.004284,0.006061
10,16,26,16087,3393033,3409120,0.001269,0.145749,0.147018
9,14,23,12884,90784,103668,0.001247,0.004363,0.005610
11,13,24,79508,315210,394718,0.005688,0.014850,0.020538
8,14,22,398,199577,199975,0.000042,0.009025,0.009067
10,14,24,44896,880706,925602,0.003280,0.037056,0.040336
10,13,23,47671,193933,241604,0.003564,0.007977,0.011541
9,13,22,4411,384664,389075,0.000514,0.015255,0.015769
10,12,22,25887,79389,105276,0.001867,0.003569,0.005436
9,15,24,808,2610282,2611090,0.000074,0.106253,0.106327
9,13,22,10279,19788,30067,0.000974,0.000918,0.001892
9,15,24,1851,1140827,1142678,0.000165,0.047837,0.048002
10,14,24,61703,655779,717482,0.004369,0.028886,0.033255
10,13,23,15142,224989,240131,0.001180,0.009515,0.010695
10,15,25,45164,6128754,6173918,0.003193,0.234654,0.237847
10,15,25,15957,1698047,1714004,0.001281,0.069772,0.071053
9,12,21,889,26288,27177,0.000128,0.001205,0.001333
9,15,24,18460,429654,448114,0.001434,0.018556,0.019990
10,12,22,55255,3231,58486,0.004217,0.000211,0.004428
10,14,24,3961,281967,285928,0.000311,0.011456,0.011767
10,12,22,19060,782,19842,0.001424,0.000071,0.001495
9,15,24,2397,328934,331331,0.000200,0.013676,0.013876
9,14,23,6112,488856,494968,0.000516,0.017739,0.018255
9,13,22,20070,22881,42951,0.001413,0.001457,0.002870
10,16,26,14976,5530864,5545840,0.001151,0.226534,0.227685
11,15,26,94190,895792,989982,0.006429,0.036797,0.043226
10,15,25,20300,782039,802339,0.001558,0.031638,0.033196
8,15,23,1400,609968,611368,0.000159,0.028758,0.028917
9,14,23,9870,470588,480458,0.000871,0.019846,0.020717
10,13,23,13428,51263,64691,0.001075,0.002615,0.003690
10,16,26,18885,1822931,1841816,0.001503,0.086883,0.088386
9,14,23,1153,1180580,1181733,0.000140,0.050669,0.050809
9,13,22,6572,96580,103152,0.000653,0.004550,0.005203
10,13,23,28829,167979,196808,0.002302,0.007521,0.009823
10,12,22,24771,31533,56304,0.002167,0.001691,0.003858
9,15,24,3421,1200810,1204231,0.000259,0.053515,0.053774
9,14,23,973,206400,207373,0.000102,0.009517,0.009619
10,14,24,7884,2779555,2787439,0.000659,0.111575,0.112234
9,15,24,10780,589390,600170,0.000891,0.026592,0.027483
9,14,23,10662,441057,451719,0.000681,0.019233,0.019914
10,14,24,5189,969815,975004,0.000477,0.040456,0.040933
9,15,24,879,378932,379811,0.000091,0.016377,0.016468
9,15,24,8300,7999000,8007300,0.000578,0.327315,0.327893
9,13,22,2002,89887,91889,0.000231,0.004533,0.004764
9,12,21,6958,42787,49745,0.000549,0.001841,0.002390
10,14,24,22803,726658,749461,0.001731,0.028959,0.030690
10,13,23,44126,581695,625821,0.003264,0.022275,0.025539
9,14,23,4431,654096,658527,0.000387,0.026742,0.027129
10,15,25,13783,3340995,3354778,0.001160,0.136206,0.137366
10,13,23,17800,14252,32052,0.001521,0.000937,0.002458
10,14,24,37062,121568,158630,0.002584,0.005319,0.007903
9,15,24,685,649626,650311,0.000062,0.027386,0.027448
9,12,21,12409,38816,51225,0.001082,0.001761,0.002843
10,15,25,24506,636738,661244,0.001777,0.028812,0.030589
10,12,22,7957,93531,101488,0.000743,0.004172,0.004915
10,13,23,43111,267347,310458,0.003146,0.010931,0.014077
10,14,24,21775,504019,525794,0.001602,0.019196,0.020798
10,13,23,24459,6885,31344,0.001809,0.000321,0.002130
10,14,24,34120,611526,645646,0.002393,0.027724,0.030117
9,12,21,2064,2549,4613,0.000189,0.000208,0.000397
9,15,24,2446,5341513,5343959,0.000209,0.206050,0.206259
10,15,25,33036,1430644,1463680,0.002502,0.055800,0.058302
10,14,24,14836,744821,759657,0.001241,0.027524,0.028765
9,14,23,6807,596855,603662,0.000568,0.025604,0.026172
9,14,23,1207,254288,255495,0.000149,0.011340,0.011489
10,14,24,37752,14570,52322,0.002855,0.001299,0.004154
9,14,23,12151,215694,227845,0.000870,0.009800,0.010670
9,15,24,9803,239146,248949,0.000784,0.012521,0.013305
10,13,23,6598,431750,438348,0.000560,0.015095,0.015655
10,15,25,36228,1685923,1722151,0.002879,0.079164,0.082043
9,14,23,2433,4506055,4508488,0.000231,0.146773,0.147004
10,14,24,17059,504729,521788,0.001381,0.022379,0.023760
11,14,25,97700,503967,601667,0.006347,0.020203,0.026550
9,14,23,2536,335001,337537,0.000240,0.015054,0.015294
9,15,24,7876,2580054,2587930,0.000680,0.093669,0.094349
9,11,20,8428,6816,15244,0.000694,0.000460,0.001154
9,14,23,7933,1355197,1363130,0.000782,0.047623,0.048405
9,12,21,12548,10051,22599,0.001030,0.000516,0.001546
10,14,24,20095,664052,684147,0.001799,0.026499,0.028298
10,13,23,8451,154043,162494,0.000796,0.005863,0.006659
8,14,22,487,1525078,1525565,0.000059,0.055918,0.055977
10,14,24,21560,339771,361331,0.001677,0.014476,0.016153
9,13,22,6877,106158,113035,0.000528,0.004311,0.004839
10,15,25,48601,5066226,5114827,0.003319,0.186275,0.189594
9,13,22,10866,62337,73203,0.000857,0.002490,0.003347
9,14,23,4226,604343,608569,0.000380,0.027907,0.028287
8,14,22,1593,336538,338131,0.000158,0.014946,0.015104
10,13,23,11328,325354,336682,0.000971,0.013098,0.014069
11,13,24,129307,163954,293261,0.009334,0.006934,0.016268
10,15,25,11874,363657,375531,0.001034,0.019783,0.020817
10,15,25,8114,2966764,2974878,0.000762,0.127194,0.127956
10,14,24,14392,886816,901208,0.001262,0.030217,0.031479
9,13,22,9895,145310,155205,0.000743,0.005561,0.006304
9,15,24,1714,1595012,1596726,0.000170,0.068868,0.069038
10,13,23,36137,96343,132480,0.002705,0.004526,0.007231
10,14,24,13526,423519,437045,0.001031,0.016851,0.017882
9,13,22,4064,119814,123878,0.000396,0.004764,0.005160
10,15,25,35190,766932,802122,0.002667,0.029120,0.031787
9,14,23,2863,1007446,1010309,0.000290,0.040246,0.040536
9,15,24,18243,3124866,3143109,0.001322,0.118857,0.120179
10,14,24,52798,325316,378114,0.003898,0.013280,0.017178
9,14,23,5321,283611,288932,0.000571,0.012528,0.013099
10,13,23,51134,114222,165356,0.003639,0.005214,0.008853
10,14,24,20965,2147274,2168239,0.001477,0.080080,0.081557
9,13,22,3757,1920,5677,0.000474,0.000203,0.000677
10,15,25,44310,327695,372005,0.002449,0.015107,0.017556
9,16,25,2196,3083206,3085402,0.000221,0.131032,0.131253
9,13,22,1256,515618,516874,0.000159,0.020036,0.020195
8,15,23,837,980319,981156,0.000102,0.040576,0.040678
8,13,21,784,3238,4022,0.000114,0.000240,0.000354
9,14,23,2336,334937,337273,0.000242,0.011981,0.012223
9,13,22,4589,146530,151119,0.000413,0.006449,0.006862
10,14,24,15543,647540,663083,0.001291,0.027416,0.028707
8,14,22,1505,129877,131382,0.000154,0.006638,0.006792
9,15,24,6383,352370,358753,0.000534,0.015545,0.016079
9,14,23,2743,1162224,1164967,0.000271,0.043844,0.044115
9,13,22,9545,307957,317502,0.000844,0.012158,0.013002
10,15,25,38490,1602589,1641079,0.002934,0.061191,0.064125
10,12,22,23259,16716,39975,0.001867,0.000855,0.002722
10,15,25,57456,240787,298243,0.004323,0.010630,0.014953
10,9,19,31093,1197,32290,0.002119,0.000081,0.002200
10,13,23,51795,27326,79121,0.003477,0.002168,0.005645
7,15,22,158,532692,532850,0.000009,0.024462,0.024471
10,13,23,131111,442948,574059,0.008274,0.016086,0.024360
10,13,23,36626,11631,48257,0.002498,0.000709,0.003207
10,12,22,18770,24585,43355,0.001326,0.001333,0.002659
10,13,23,84151,314741,398892,0.005753,0.012243,0.017996
10,15,25,33337,372002,405339,0.002252,0.016779,0.019031
10,13,23,16658,647917,664575,0.001292,0.023926,0.025218
10,15,25,11114,1076914,1088028,0.000852,0.049602,0.050454
9,14,23,6904,103633,110537,0.000622,0.004873,0.005495
10,13,23,14481,58415,72896,0.001109,0.002522,0.003631
9,14,23,4421,12938,17359,0.000343,0.000961,0.001304
9,12,21,11974,240913,252887,0.000921,0.009097,0.010018
8,15,23,273,4700880,4701153,0.000027,0.195580,0.195607
9,13,22,9602,56468,66070,0.000777,0.002473,0.003250
10,13,23,28577,32376,60953,0.002070,0.001461,0.003531
10,13,23,20783,149775,170558,0.001481,0.005840,0.007321
10,13,23,43523,131055,174578,0.002808,0.005362,0.008170
11,14,25,103078,117650,220728,0.006552,0.004909,0.011461
10,14,24,26884,331322,358206,0.001885,0.012889,0.014774
9,15,24,5949,1994774,2000723,0.000508,0.071250,0.071758
10,14,24,17446,387989,405435,0.001445,0.015046,0.016491
10,13,23,41884,81268,123152,0.003233,0.004052,0.007285
9,12,21,3567,25414,28981,0.000288,0.001319,0.001607
10,13,23,35181,26425,61606,0.002590,0.001516,0.004106
10,13,23,16232,160763,176995,0.001207,0.006762,0.007969
10,13,23,19400,32475,51875,0.001391,0.001666,0.003057
10,13,23,17612,101738,119350,0.001329,0.004949,0.006278
9,13,22,3801,132796,136597,0.000293,0.005019,0.005312
10,15,25,11407,3298481,3309888,0.000942,0.126242,0.127184
10,13,23,8895,5128,14023,0.000787,0.000392,0.001179
10,14,24,19060,418800,437860,0.001313,0.016524,0.017837
9,14,23,10408,915197,925605,0.000855,0.033704,0.034559
8,14,22,740,47599,48339,0.000074,0.002046,0.002120
10,12,22,40631,1340,41971,0.002918,0.000106,0.003024
9,15,24,4300,1430881,1435181,0.000327,0.059621,0.059948
10,12,22,35694,108436,144130,0.002378,0.004077,0.006455
10,13,23,85278,301,85579,0.005696,0.000031,0.005727
10,13,23,30806,28878,59684,0.001801,0.001497,0.003298
10,16,26,10637,8416853,8427490,0.001126,0.335354,0.336480
9,13,22,5251,10606,15857,0.000508,0.000670,0.001178
10,14,24,54052,1092077,1146129,0.003870,0.042424,0.046294
10,15,25,12037,2665163,2677200,0.000998,0.103434,0.104432
10,15,25,15551,713830,729381,0.001236,0.028279,0.029515
8,13,21,2614,382205,384819,0.000214,0.014905,0.015119
10,13,23,36468,95409,131877,0.002904,0.004510,0.007414
9,14,23,5646,1409526,1415172,0.000468,0.053887,0.054355
11,14,25,156858,864538,1021396,0.009820,0.032004,0.041824
10,15,25,39141,1310277,1349418,0.002852,0.057072,0.059924
10,14,24,134416,165794,300210,0.008290,0.006436,0.014726
10,15,25,15790,2214764,2230554,0.001168,0.085497,0.086665
10,12,22,12829,140527,153356,0.001050,0.005149,0.006199
9,12,21,3891,12354,16245,0.000307,0.000655,0.000962
10,14,24,43067,174657,217724,0.002942,0.007713,0.010655
9,13,22,8488,31395,39883,0.000701,0.001659,0.002360
11,14,25,121343,3851465,3972808,0.007376,0.127796,0.135172
10,15,25,38697,1494874,1533571,0.002683,0.057832,0.060515
10,13,23,14850,110559,125409,0.001311,0.004502,0.005813
9,16,25,7062,3610650,3617712,0.000610,0.142154,0.142764
10,13,23,22937,18198,41135,0.001684,0.001015,0.002699
9,13,22,18585,286360,304945,0.001282,0.011795,0.013077
10,15,25,44241,511522,555763,0.003120,0.022202,0.025322
9,11,20,10883,11307,22190,0.000851,0.000586,0.001437
10,15,25,61296,337645,398941,0.003795,0.014858,0.018653
8,13,21,3768,74098,77866,0.000329,0.002632,0.002961
9,15,24,2637,213582,216219,0.000237,0.009166,0.009403
9,15,24,14992,2379775,2394767,0.001096,0.092116,0.093212
10,12,22,13229,7242,20471,0.001110,0.000415,0.001525
9,16,25,1800,5383076,5384876,0.000192,0.204489,0.204681
9,14,23,2212,190310,192522,0.000207,0.007560,0.007767
8,15,23,496,2563669,2564165,0.000044,0.097796,0.097840
10,14,24,10144,420988,431132,0.000862,0.016170,0.017032
9,16,25,7188,7585647,7592835,0.000599,0.279514,0.280113
9,15,24,6123,433510,439633,0.000552,0.015689,0.016241
9,14,23,3364,599143,602507,0.000304,0.021033,0.021337
9,15,24,8745,1674082,1682827,0.000752,0.057681,0.058433
10,13,23,17975,23967,41942,0.001446,0.001194,0.002640
10,13,23,35758,46397,82155,0.002709,0.001970,0.004679
10,14,24,51175,4738818,4789993,0.003701,0.169008,0.172709
9,14,23,4705,245095,249800,0.000403,0.008861,0.009264
10,14,24,29344,209830,239174,0.002362,0.008783,0.011145
8,15,23,888,3341016,3341904,0.000075,0.118657,0.118732
10,14,24,77427,254859,332286,0.005888,0.009256,0.015144
9,13,22,7480,25795,33275,0.000593,0.001377,0.001970
10,15,25,53471,672636,726107,0.004144,0.027025,0.031169
10,14,24,14470,1177494,1191964,0.001145,0.039509,0.040654
10,15,25,63587,430106,493693,0.004795,0.017274,0.022069
9,12,21,10404,21684,32088,0.000848,0.000992,0.001840
9,12,21,4306,41241,45547,0.000353,0.001830,0.002183
10,16,26,77063,3845086,3922149,0.005934,0.150709,0.156643
9,11,20,9396,26421,35817,0.000806,0.001038,0.001844
8,15,23,796,1157460,1158256,0.000060,0.041660,0.041720
10,14,24,9916,269044,278960,0.000861,0.010789,0.011650
9,15,24,7886,4739466,4747352,0.000663,0.181500,0.182163
9,15,24,741,1080527,1081268,0.000079,0.042165,0.042244
9,15,24,8176,1113412,1121588,0.000698,0.041878,0.042576
8,14,22,1658,599254,600912,0.000164,0.021879,0.022043
8,13,21,1731,434967,436698,0.000156,0.016249,0.016405
10,15,25,16227,364854,381081,0.001435,0.013335,0.014770
8,13,21,3342,114765,118107,0.000261,0.004800,0.005061
9,13,22,10628,75706,86334,0.000863,0.003142,0.004005
10,15,25,35162,1871288,1906450,0.002880,0.067852,0.070732
9,13,22,6410,78411,84821,0.000573,0.003174,0.003747
10,14,24,45919,1414920,1460839,0.003703,0.050270,0.053973
10,16,26,5056,2875155,2880211,0.000429,0.106606,0.107035
8,13,21,392,62428,62820,0.000040,0.002839,0.002879
10,16,26,12003,3098826,3110829,0.001035,0.125150,0.126185
10,13,23,16254,695,16949,0.001392,0.000057,0.001449
9,16,25,10752,1745904,1756656,0.000853,0.069268,0.070121
9,13,22,2628,197483,200111,0.000218,0.007501,0.007719
10,15,25,8452,2663319,2671771,0.000793,0.094874,0.095667
9,15,24,1981,1297368,1299349,0.000188,0.047574,0.047762
10,12,22,23487,16758,40245,0.001949,0.000735,0.002684
10,14,24,31816,493535,525351,0.002549,0.019261,0.021810
10,14,24,15546,864630,880176,0.001296,0.032585,0.033881
9,15,24,16244,3463433,3479677,0.001311,0.139165,0.140476
10,15,25,9162,415483,424645,0.000803,0.017871,0.018674
9,14,23,7885,213738,221623,0.000711,0.009267,0.009978
9,14,23,3842,1311969,1315811,0.000330,0.045750,0.046080
8,14,22,1136,1904046,1905182,0.000097,0.066864,0.066961
9,15,24,5202,761543,766745,0.000483,0.028723,0.029206
9,12,21,8319,68096,76415,0.000727,0.002718,0.003445
9,14,23,2260,170438,172698,0.000202,0.007001,0.007203
10,14,24,7993,699660,707653,0.000702,0.025936,0.026638
10,14,24,7862,516781,524643,0.000697,0.019121,0.019818
9,15,24,1660,3007888,3009548,0.000153,0.110216,0.110369
9,14,23,29222,352836,382058,0.002255,0.013641,0.015896
9,14,23,7050,167783,174833,0.000560,0.006790,0.007350
10,13,23,12653,214262,226915,0.001026,0.008600,0.009626
9,14,23,3396,221348,224744,0.000249,0.009268,0.009517
10,13,23,24232,4738,28970,0.002040,0.000262,0.002302
8,15,23,689,251287,251976,0.000055,0.009887,0.009942
10,16,26,73608,1402345,1475953,0.005063,0.056483,0.061546
10,15,25,23365,1547221,1570586,0.002015,0.052746,0.054761
10,14,24,13045,248189,261234,0.001121,0.010565,0.011686
10,15,25,6856,2293550,2300406,0.000608,0.086651,0.087259
9,14,23,2390,4065203,4067593,0.000220,0.134143,0.134363
9,14,23,6678,1236153,1242831,0.000555,0.042356,0.042911
10,14,24,15626,620300,635926,0.001307,0.020641,0.021948
9,13,22,6098,216276,222374,0.000506,0.008715,0.009221
10,13,23,23228,14789,38017,0.001990,0.001022,0.003012
8,14,22,4321,169438,173759,0.000366,0.007003,0.007369
10,15,25,45605,5627540,5673145,0.003471,0.218453,0.221924
9,15,24,6864,151700,158564,0.000632,0.006360,0.006992
10,14,24,49831,53697,103528,0.003802,0.002917,0.006719
10,13,23,13345,13507,26852,0.001020,0.000738,0.001758
9,15,24,5591,2415061,2420652,0.000449,0.093666,0.094115
9,14,23,9137,1322872,1332009,0.000769,0.045428,0.046197
10,15,25,20889,332221,353110,0.001683,0.013686,0.015369
10,15,25,14133,2260245,2274378,0.001231,0.080757,0.081988
10,13,23,7977,239703,247680,0.000691,0.009541,0.010232
9,14,23,9824,195949,205773,0.000741,0.007636,0.008377
10,13,23,52408,87247,139655,0.004046,0.004330,0.008376
10,14,24,41909,1657120,1699029,0.003298,0.058882,0.062180
9,13,22,8663,25291,33954,0.000737,0.001124,0.001861
9,14,23,2518,567940,570458,0.000207,0.022291,0.022498
10,13,23,107126,239713,346839,0.007985,0.010103,0.018088
9,15,24,1000,271844,272844,0.000084,0.011279,0.011363
10,14,24,36396,2230143,2266539,0.002861,0.079727,0.082588
10,15,25,23777,601056,624833,0.001871,0.027601,0.029472
10,15,25,13601,1951094,1964695,0.001178,0.071329,0.072507
11,14,25,97419,227878,325297,0.007645,0.009200,0.016845
10,15,25,7132,257094,264226,0.000567,0.010444,0.011011
9,15,24,3090,514313,517403,0.000256,0.021257,0.021513
10,14,24,17680,170036,187716,0.001530,0.006906,0.008436
8,14,22,629,1063829,1064458,0.000054,0.035754,0.035808
10,14,24,9265,3618553,3627818,0.000814,0.126973,0.127787
8,14,22,1125,1263457,1264582,0.000099,0.044464,0.044563
10,13,23,23113,157948,181061,0.002179,0.006698,0.008877
10,13,23,11809,69396,81205,0.001601,0.003643,0.005244
10,15,25,17634,5522833,5540467,0.001553,0.208027,0.209580
10,15,25,26019,1055614,1081633,0.002469,0.054146,0.056615
10,15,25,18750,680632,699382,0.001620,0.028027,0.029647
10,14,24,64000,104801,168801,0.004937,0.005101,0.010038
9,14,23,3036,92504,95540,0.000241,0.004484,0.004725
9,13,22,1446,76774,78220,0.000158,0.004213,0.004371
10,14,24,41894,72063,113957,0.002680,0.003835,0.006515
9,14,23,4295,772660,776955,0.000363,0.031068,0.031431
8,15,23,2842,173314,176156,0.000295,0.007976,0.008271
10,14,24,44884,624687,669571,0.004034,0.026457,0.030491
10,13,23,34161,119444,153605,0.002611,0.005473,0.008084
10,14,24,15468,783131,798599,0.001240,0.031962,0.033202
10,14,24,30605,73720,104325,0.002183,0.003277,0.005460
10,14,24,35503,146183,181686,0.002456,0.006841,0.009297
10,15,25,13075,811800,824875,0.001056,0.032283,0.033339
9,12,21,15357,39744,55101,0.001215,0.001968,0.003183
9,14,23,2197,418886,421083,0.000213,0.017105,0.017318
10,14,24,22562,693807,716369,0.001992,0.027437,0.029429
9,13,22,9896,41314,51210,0.000887,0.002028,0.002915
9,15,24,2103,1619097,1621200,0.000182,0.058264,0.058446
10,14,24,6964,12776,19740,0.000654,0.001054,0.001708
10,14,24,14285,1448620,1462905,0.001196,0.055776,0.056972
10,15,25,20023,1878002,1898025,0.001815,0.072152,0.073967
9,14,23,1694,171326,173020,0.000206,0.007764,0.007970
10,15,25,12190,423442,435632,0.001099,0.017908,0.019007
10,15,25,70911,987449,1058360,0.005309,0.042609,0.047918
10,12,22,31671,12890,44561,0.002814,0.000865,0.003679
7,14,21,577,214380,214957,0.000063,0.009948,0.010011
9,14,23,7161,1941795,1948956,0.000587,0.069361,0.069948
10,15,25,37225,802453,839678,0.003193,0.031940,0.035133
10,15,25,77768,1059454,1137222,0.005987,0.044433,0.050420
10,14,24,16747,559584,576331,0.001673,0.027078,0.028751
10,14,24,26505,101743,128248,0.002508,0.004245,0.006753
9,11,20,3695,4701,8396,0.000325,0.000285,0.000610
9,14,23,1863,9551220,9553083,0.000187,0.319723,0.319910
10,11,21,20659,1671,22330,0.001640,0.000114,0.001754
10,15,25,35782,461245,497027,0.003763,0.020028,0.023791
9,14,23,4098,139017,143115,0.000382,0.006561,0.006943
8,14,22,2599,1349393,1351992,0.000235,0.048431,0.048666
10,15,25,18386,900145,918531,0.001778,0.035617,0.037395
9,12,21,3441,14835,18276,0.000355,0.000921,0.001276
10,13,23,89310,20755,110065,0.007761,0.001035,0.008796
11,15,26,91145,4216145,4307290,0.006069,0.159586,0.165655
10,14,24,7447,135322,142769,0.000725,0.006287,0.007012
9,15,24,1138,1986632,1987770,0.000122,0.078449,0.078571
10,14,24,54616,1704891,1759507,0.004661,0.066483,0.071144
9,14,23,6564,675036,681600,0.000634,0.025331,0.025965
10,13,23,11392,12256,23648,0.001151,0.000656,0.001807
9,14,23,16221,13173,29394,0.001303,0.000987,0.002290
10,13,23,29423,74086,103509,0.002455,0.003754,0.006209
10,14,24,24479,99962,124441,0.002447,0.005116,0.007563
9,13,22,5216,111399,116615,0.000438,0.005099,0.005537
10,14,24,8607,329810,338417,0.000746,0.014885,0.015631
9,13,22,8469,19703,28172,0.000715,0.001226,0.001941
10,16,26,39792,3553006,3592798,0.003131,0.142216,0.145347
10,12,22,72277,36065,108342,0.005466,0.002010,0.007476
9,16,25,7262,4587825,4595087,0.000591,0.180683,0.181274
10,14,24,30851,184609,215460,0.002688,0.008428,0.011116
10,14,24,43187,1864970,1908157,0.003714,0.062662,0.066376
10,12,22,11907,2449,14356,0.001229,0.000200,0.001429
8,15,23,637,948585,949222,0.000080,0.044712,0.044792
9,14,23,2041,977218,979259,0.000352,0.037016,0.037368
10,13,23,17102,147379,164481,0.001648,0.005748,0.007396
10,15,25,24137,896689,920826,0.002011,0.035639,0.037650
9,12,21,3091,105027,108118,0.000345,0.004906,0.005251
10,15,25,8960,796243,805203,0.000787,0.031552,0.032339
10,14,24,44542,355402,399944,0.003178,0.016041,0.019219
9,15,24,12979,466410,479389,0.001208,0.020222,0.021430
11,14,25,92860,1301422,1394282,0.007777,0.046272,0.054049
9,13,22,828,213800,214628,0.000123,0.009569,0.009692
10,14,24,16097,107969,124066,0.001417,0.006538,0.007955
8,14,22,1756,1805692,1807448,0.000249,0.065761,0.066010
10,13,23,39927,279837,319764,0.003512,0.010970,0.014482
8,16,24,248,2308890,2309138,0.000026,0.093645,0.093671
10,15,25,42105,689288,731393,0.003703,0.030006,0.033709
10,15,25,20815,571145,591960,0.001923,0.022426,0.024349
9,14,23,3388,296091,299479,0.000333,0.012185,0.012518
9,14,23,3913,328832,332745,0.000378,0.015048,0.015426
10,15,25,13103,3437408,3450511,0.001101,0.130659,0.131760
10,14,24,14807,197330,212137,0.001454,0.008667,0.010121
9,16,25,9525,1877298,1886823,0.000887,0.077472,0.078359
9,15,24,9667,1086174,1095841,0.001087,0.043576,0.044663
7,15,22,206,682210,682416,0.000019,0.041246,0.041265
9,15,24,2604,516742,519346,0.000271,0.025439,0.025710
9,15,24,1587,1848936,1850523,0.000202,0.069040,0.069242
10,15,25,15304,1953322,1968626,0.001446,0.073470,0.074916
10,14,24,16910,392574,409484,0.001668,0.017316,0.018984
10,15,25,10163,1524947,1535110,0.000981,0.056731,0.057712
10,15,25,47360,1019046,1066406,0.004517,0.042881,0.047398
10,15,25,33571,10981683,11015254,0.002968,0.348195,0.351163
10,15,25,19162,213554,232716,0.001787,0.010194,0.011981
10,15,25,16306,1242725,1259031,0.001437,0.052046,0.053483
9,14,23,6125,100096,106221,0.000640,0.004392,0.005032
10,16,26,21677,3925590,3947267,0.002086,0.156977,0.159063
10,14,24,18269,223549,241818,0.001596,0.010239,0.011835
9,13,22,22471,1085,23556,0.001855,0.000097,0.001952
11,13,24,72600,5174,77774,0.005679,0.000285,0.005964
10,14,24,30123,652942,683065,0.002268,0.027287,0.029555
9,15,24,18495,134803,153298,0.001518,0.005997,0.007515
8,11,19,1524,9193,10717,0.000134,0.000413,0.000547
10,14,24,25737,168500,194237,0.002686,0.007209,0.009895
9,14,23,853,7533795,7534648,0.000094,0.272955,0.273049
9,15,24,10118,2796634,2806752,0.001035,0.104435,0.105470
8,14,22,545,223262,223807,0.000074,0.010227,0.010301
10,10,20,12990,966,13956,0.001131,0.000058,0.001189
10,13,23,20019,158400,178419,0.001567,0.007423,0.008990
10,15,25,37194,4778112,4815306,0.003172,0.180777,0.183949
10,14,24,16428,64976,81404,0.001573,0.002941,0.004514
10,15,25,20077,939665,959742,0.001634,0.044484,0.046118
9,14,23,5750,275675,281425,0.000581,0.014730,0.015311
10,14,24,25060,80962,106022,0.002135,0.004327,0.006462
10,16,26,16087,3393033,3409120,0.001349,0.131757,0.133106
9,14,23,12884,90784,103668,0.001181,0.004804,0.005985
11,13,24,79508,315210,394718,0.006250,0.014840,0.021090
8,14,22,398,199577,199975,0.000052,0.008966,0.009018
10,14,24,44896,880706,925602,0.004494,0.033785,0.038279
10,13,23,47671,193933,241604,0.004163,0.008219,0.012382
9,13,22,4411,384664,389075,0.000392,0.016038,0.016430
10,12,22,25887,79389,105276,0.002670,0.003477,0.006147
9,15,24,808,2610282,2611090,0.000086,0.098628,0.098714
9,13,22,10279,19788,30067,0.001091,0.000803,0.001894
9,15,24,1851,1140827,1142678,0.000186,0.052658,0.052844
10,14,24,61703,655779,717482,0.004819,0.026559,0.031378
10,13,23,15142,224989,240131,0.001363,0.009662,0.011025
10,15,25,45164,6128754,6173918,0.003502,0.220546,0.224048
10,15,25,15957,1698047,1714004,0.001535,0.066328,0.067863
9,12,21,889,26288,27177,0.000164,0.001504,0.001668
9,15,24,18460,429654,448114,0.001559,0.020152,0.021711
10,12,22,55255,3231,58486,0.005143,0.000189,0.005332
10,14,24,3961,281967,285928,0.000360,0.012153,0.012513
10,12,22,19060,782,19842,0.002076,0.000071,0.002147
9,15,24,2397,328934,331331,0.000226,0.015204,0.015430
9,14,23,6112,488856,494968,0.000565,0.019063,0.019628
9,13,22,20070,22881,42951,0.001534,0.001408,0.002942
10,16,26,14976,5530864,5545840,0.001253,0.221360,0.222613
11,15,26,94190,895792,989982,0.007950,0.035482,0.043432
10,15,25,20300,782039,802339,0.001829,0.031775,0.033604
8,15,23,1400,609968,611368,0.000167,0.027985,0.028152
9,14,23,9870,470588,480458,0.000995,0.020304,0.021299
10,13,23,13428,51263,64691,0.001297,0.002703,0.004000
10,16,26,18885,1822931,1841816,0.001666,0.077531,0.079197
9,14,23,1153,1180580,1181733,0.000149,0.045084,0.045233
9,13,22,6572,96580,103152,0.000651,0.004788,0.005439
10,13,23,28829,167979,196808,0.002519,0.007106,0.009625
10,12,22,24771,31533,56304,0.002634,0.001756,0.004390
9,15,24,3421,1200810,1204231,0.000279,0.048893,0.049172
9,14,23,973,206400,207373,0.000138,0.012587,0.012725
10,14,24,7884,2779555,2787439,0.000708,0.100628,0.101336
9,15,24,10780,589390,600170,0.001048,0.025616,0.026664
9,14,23,10662,441057,451719,0.000814,0.018805,0.019619
10,14,24,5189,969815,975004,0.000519,0.038077,0.038596
9,15,24,879,378932,379811,0.000125,0.016008,0.016133
9,15,24,8300,7999000,8007300,0.000754,0.290551,0.291305
9,13,22,2002,89887,91889,0.000236,0.004184,0.004420
9,12,21,6958,42787,49745,0.000606,0.001760,0.002366
10,14,24,22803,726658,749461,0.001981,0.028919,0.030900
10,13,23,44126,581695,625821,0.003665,0.021448,0.025113
9,14,23,4431,654096,658527,0.000442,0.026055,0.026497
10,15,25,13783,3340995,3354778,0.001315,0.121917,0.123232
10,13,23,17800,14252,32052,0.001600,0.000917,0.002517
10,14,24,37062,121568,158630,0.002988,0.005225,0.008213
9,15,24,685,649626,650311,0.000083,0.027064,0.027147
9,12,21,12409,38816,51225,0.001094,0.001676,0.002770
10,15,25,24506,636738,661244,0.002023,0.028217,0.030240
10,12,22,7957,93531,101488,0.000786,0.004400,0.005186
10,13,23,43111,267347,310458,0.003497,0.010905,0.014402
10,14,24,21775,504019,525794,0.001781,0.019587,0.021368
10,13,23,24459,6885,31344,0.002037,0.000356,0.002393
10,14,24,34120,611526,645646,0.002700,0.026785,0.029485
9,12,21,2064,2549,4613,0.000216,0.000205,0.000421
9,15,24,2446,5341513,5343959,0.000240,0.193412,0.193652
10,15,25,33036,1430644,1463680,0.002838,0.056191,0.059029
10,14,24,14836,744821,759657,0.001369,0.028430,0.029799
9,14,23,6807,596855,603662,0.000619,0.022830,0.023449
9,14,23,1207,254288,255495,0.000155,0.011385,0.011540
10,14,24,37752,14570,52322,0.003166,0.001233,0.004399
9,14,23,12151,215694,227845,0.000967,0.009834,0.010801
9,15,24,9803,239146,248949,0.000852,0.012185,0.013037
10,13,23,6598,431750,438348,0.000596,0.014725,0.015321
10,15,25,36228,1685923,1722151,0.002870,0.071653,0.074523
9,14,23,2433,4506055,4508488,0.000282,0.141737,0.142019
10,14,24,17059,504729,521788,0.001550,0.020095,0.021645
11,14,25,97700,503967,601667,0.007705,0.021517,0.029222
9,14,23,2536,335001,337537,0.000268,0.014957,0.015225
9,15,24,7876,2580054,2587930,0.000782,0.092592,0.093374
9,11,20,8428,6816,15244,0.000805,0.000389,0.001194
9,14,23,7933,1355197,1363130,0.000720,0.048100,0.048820
9,12,21,12548,10051,22599,0.001125,0.000528,0.001653
10,14,24,20095,664052,684147,0.001759,0.028131,0.029890
10,13,23,8451,154043,162494,0.000778,0.006272,0.007050
8,14,22,487,1525078,1525565,0.000042,0.056638,0.056680
10,14,24,21560,339771,361331,0.001883,0.014386,0.016269
9,13,22,6877,106158,113035,0.000605,0.004606,0.005211
10,15,25,48601,5066226,5114827,0.004016,0.185340,0.189356
9,13,22,10866,62337,73203,0.001049,0.002600,0.003649
9,14,23,4226,604343,608569,0.000397,0.025731,0.026128
8,14,22,1593,336538,338131,0.000145,0.015127,0.015272
10,13,23,11328,325354,336682,0.001208,0.014239,0.015447
11,13,24,129307,163954,293261,0.011019,0.007982,0.019001
10,15,25,11874,363657,375531,0.001107,0.019796,0.020903
10,15,25,8114,2966764,2974878,0.000816,0.111396,0.112212
10,14,24,14392,886816,901208,0.001397,0.031850,0.033247
9,13,22,9895,145310,155205,0.000861,0.006099,0.006960
9,15,24,1714,1595012,1596726,0.000184,0.064429,0.064613
10,13,23,36137,96343,132480,0.003152,0.004897,0.008049
10,14,24,13526,423519,437045,0.001141,0.018648,0.019789
9,13,22,4064,119814,123878,0.000421,0.005257,0.005678
10,15,25,35190,766932,802122,0.003122,0.030459,0.033581
9,14,23,2863,1007446,1010309,0.000306,0.038292,0.038598
9,15,24,18243,3124866,3143109,0.001585,0.115468,0.117053
10,14,24,52798,325316,378114,0.004553,0.013926,0.018479
9,14,23,5321,283611,288932,0.000520,0.013364,0.013884
10,13,23,51134,114222,165356,0.004142,0.005675,0.009817
10,14,24,20965,2147274,2168239,0.001779,0.078109,0.079888
9,13,22,3757,1920,5677,0.000403,0.000157,0.000560
10,15,25,44310,327695,372005,0.002836,0.016193,0.019029
9,16,25,2196,3083206,3085402,0.000222,0.121848,0.122070
9,13,22,1256,515618,516874,0.000164,0.019962,0.020126
8,15,23,837,980319,981156,0.000115,0.040536,0.040651
8,13,21,784,3238,4022,0.000107,0.000255,0.000362
9,14,23,2336,334937,337273,0.000252,0.012493,0.012745
9,13,22,4589,146530,151119,0.000424,0.007160,0.007584
10,14,24,15543,647540,663083,0.001418,0.026395,0.027813
8,14,22,1505,129877,131382,0.000147,0.007629,0.007776
9,15,24,6383,352370,358753,0.000569,0.017589,0.018158
9,14,23,2743,1162224,1164967,0.000277,0.044938,0.045215
9,13,22,9545,307957,317502,0.000916,0.012930,0.013846
10,15,25,38490,1602589,1641079,0.003370,0.072759,0.076129
10,12,22,23259,16716,39975,0.001930,0.000799,0.002729
10,15,25,57456,240787,298243,0.004159,0.010823,0.014982
10,9,19,31093,1197,32290,0.002156,0.000082,0.002238
10,13,23,51795,27326,79121,0.003806,0.002104,0.005910
7,15,22,158,532692,532850,0.000009,0.023830,0.023839
10,13,23,131111,442948,574059,0.008437,0.016599,0.025036
10,13,23,36626,11631,48257,0.002550,0.000677,0.003227
10,12,22,18770,24585,43355,0.001336,0.001387,0.002723
10,13,23,84151,314741,398892,0.005491,0.012116,0.017607
10,15,25,33337,372002,405339,0.002283,0.017296,0.019579
10,13,23,16658,647917,664575,0.001334,0.024135,0.025469
10,15,25,11114,1076914,1088028,0.000851,0.040845,0.041696
9,14,23,6904,103633,110537,0.000603,0.004286,0.004889
10,13,23,14481,58415,72896,0.001090,0.002486,0.003576
9,14,23,4421,12938,17359,0.000356,0.000988,0.001344
9,12,21,11974,240913,252887,0.000917,0.008431,0.009348
8,15,23,273,4700880,4701153,0.000030,0.175542,0.175572
9,13,22,9602,56468,66070,0.000912,0.002466,0.003378
10,13,23,28577,32376,60953,0.002382,0.001543,0.003925
10,13,23,20783,149775,170558,0.001804,0.006380,0.008184
10,13,23,43523,131055,174578,0.003130,0.005545,0.008675
11,14,25,103078,117650,220728,0.007927,0.004995,0.012922
10,14,24,26884,331322,358206,0.001954,0.014377,0.016331
9,15,24,5949,1994774,2000723,0.000526,0.072366,0.072892
10,14,24,17446,387989,405435,0.001616,0.015372,0.016988
10,13,23,41884,81268,123152,0.003627,0.004391,0.008018
9,12,21,3567,25414,28981,0.000292,0.001364,0.001656
10,13,23,35181,26425,61606,0.003057,0.001505,0.004562
10,13,23,16232,160763,176995,0.001424,0.007415,0.008839
10,13,23,19400,32475,51875,0.001533,0.001813,0.003346
10,13,23,17612,101738,119350,0.001428,0.005329,0.006757
9,13,22,3801,132796,136597,0.000296,0.005087,0.005383
10,15,25,11407,3298481,3309888,0.000945,0.126983,0.127928
10,13,23,8895,5128,14023,0.000889,0.000373,0.001262
10,14,24,19060,418800,437860,0.001577,0.017811,0.019388
9,14,23,10408,915197,925605,0.000978,0.035216,0.036194
8,14,22,740,47599,48339,0.000080,0.002246,0.002326
10,12,22,40631,1340,41971,0.003426,0.000092,0.003518
9,15,24,4300,1430881,1435181,0.000368,0.058607,0.058975
10,12,22,35694,108436,144130,0.002810,0.004220,0.007030
10,13,23,85278,301,85579,0.006835,0.000029,0.006864
10,13,23,30806,28878,59684,0.002082,0.001523,0.003605
10,16,26,10637,8416853,8427490,0.000816,0.349378,0.350194
9,13,22,5251,10606,15857,0.000546,0.000670,0.001216
10,14,24,54052,1092077,1146129,0.004220,0.040670,0.044890
10,15,25,12037,2665163,2677200,0.001124,0.100952,0.102076
10,15,25,15551,713830,729381,0.001421,0.029384,0.030805
8,13,21,2614,382205,384819,0.000232,0.015236,0.015468
10,13,23,36468,95409,131877,0.003185,0.004837,0.008022
9,14,23,5646,1409526,1415172,0.000502,0.054285,0.054787
11,14,25,156858,864538,1021396,0.011596,0.033252,0.044848
10,15,25,39141,1310277,1349418,0.003188,0.058084,0.061272
10,14,24,134416,165794,300210,0.009510,0.007256,0.016766
10,15,25,15790,2214764,2230554,0.001150,0.080900,0.082050
10,12,22,12829,140527,153356,0.001182,0.005099,0.006281
9,12,21,3891,12354,16245,0.000350,0.000634,0.000984
10,14,24,43067,174657,217724,0.003287,0.008470,0.011757
9,13,22,8488,31395,39883,0.000716,0.001580,0.002296
11,14,25,121343,3851465,3972808,0.008036,0.128513,0.136549
10,15,25,38697,1494874,1533571,0.003125,0.056225,0.059350
10,13,23,14850,110559,125409,0.001417,0.004442,0.005859
9,16,25,7062,3610650,3617712,0.000636,0.159781,0.160417
10,13,23,22937,18198,41135,0.001917,0.001003,0.002920
9,13,22,18585,286360,304945,0.001450,0.012781,0.014231
10,15,25,44241,511522,555763,0.003575,0.023998,0.027573
9,11,20,10883,11307,22190,0.000927,0.000560,0.001487
10,15,25,61296,337645,398941,0.004624,0.015625,0.020249
8,13,21,3768,74098,77866,0.000362,0.002860,0.003222
9,15,24,2637,213582,216219,0.000253,0.009974,0.010227
9,15,24,14992,2379775,2394767,0.001198,0.092774,0.093972
10,12,22,13229,7242,20471,0.001201,0.000457,0.001658
9,16,25,1800,5383076,5384876,0.000196,0.199553,0.199749
9,14,23,2212,190310,192522,0.000196,0.006988,0.007184
8,15,23,496,2563669,2564165,0.000044,0.096703,0.096747
10,14,24,10144,420988,431132,0.000926,0.016249,0.017175
9,16,25,7188,7585647,7592835,0.000590,0.273643,0.274233
9,15,24,6123,433510,439633,0.000515,0.017732,0.018247
9,14,23,3364,599143,602507,0.000303,0.024421,0.024724
9,15,24,8745,1674082,1682827,0.000717,0.058203,0.058920
10,13,23,17975,23967,41942,0.001283,0.001163,0.002446
10,13,23,35758,46397,82155,0.002267,0.002016,0.004283
10,14,24,51175,4738818,4789993,0.003101,0.165579,0.168680
9,14,23,4705,245095,249800,0.000394,0.009250,0.009644
10,14,24,29344,209830,239174,0.002055,0.008577,0.010632
8,15,23,888,3341016,3341904,0.000088,0.119458,0.119546
10,14,24,77427,254859,332286,0.004916,0.008999,0.013915
9,13,22,7480,25795,33275,0.000555,0.001271,0.001826
10,15,25,53471,672636,726107,0.003676,0.025643,0.029319
10,14,24,14470,1177494,1191964,0.001027,0.038342,0.039369
10,15,25,63587,430106,493693,0.004030,0.016347,0.020377
9,12,21,10404,21684,32088,0.000808,0.000929,0.001737
9,12,21,4306,41241,45547,0.000327,0.001764,0.002091
10,16,26,77063,3845086,3922149,0.005027,0.158686,0.163713
9,11,20,9396,26421,35817,0.000719,0.000996,0.001715
8,15,23,796,1157460,1158256,0.000059,0.047714,0.047773
10,14,24,9916,269044,278960,0.000785,0.010652,0.011437
9,15,24,7886,4739466,4747352,0.000631,0.171018,0.171649
9,15,24,741,1080527,1081268,0.000076,0.044433,0.044509
9,15,24,8176,1113412,1121588,0.000654,0.040902,0.041556
8,14,22,1658,599254,600912,0.000165,0.021928,0.022093
8,13,21,1731,434967,436698,0.000154,0.015196,0.015350
10,15,25,16227,364854,381081,0.001297,0.012562,0.013859
8,13,21,3342,114765,118107,0.000251,0.004558,0.004809
9,13,22,10628,75706,86334,0.000780,0.002909,0.003689
10,15,25,35162,1871288,1906450,0.002550,0.065339,0.067889
9,13,22,6410,78411,84821,0.000536,0.002973,0.003509
10,14,24,45919,1414920,1460839,0.003219,0.048163,0.051382
10,16,26,5056,2875155,2880211,0.000402,0.103184,0.103586
8,13,21,392,62428,62820,0.000039,0.002648,0.002687
10,16,26,12003,3098826,3110829,0.000926,0.120699,0.121625
10,13,23,16254,695,16949,0.001241,0.000065,0.001306
9,16,25,10752,1745904,1756656,0.000748,0.077205,0.077953
9,13,22,2628,197483,200111,0.000226,0.008217,0.008443
10,15,25,8452,2663319,2671771,0.000744,0.113709,0.114453
9,15,24,1981,1297368,1299349,0.000181,0.054041,0.054222
10,12,22,23487,16758,40245,0.001726,0.000766,0.002492
10,14,24,31816,493535,525351,0.002426,0.024604,0.027030
10,14,24,15546,864630,880176,0.001298,0.033734,0.035032
9,15,24,16244,3463433,3479677,0.001180,0.125586,0.126766
10,15,25,9162,415483,424645,0.000725,0.014862,0.015587
9,14,23,7885,213738,221623,0.000623,0.008273,0.008896
9,14,23,3842,1311969,1315811,0.000318,0.043264,0.043582
8,14,22,1136,1904046,1905182,0.000107,0.071568,0.071675
9,15,24,5202,761543,766745,0.000449,0.030298,0.030747
9,12,21,8319,68096,76415,0.000693,0.002707,0.003400
9,14,23,2260,170438,172698,0.000193,0.007026,0.007219
10,14,24,7993,699660,707653,0.000662,0.026277,0.026939
10,14,24,7862,516781,524643,0.000663,0.020855,0.021518
9,15,24,1660,3007888,3009548,0.000157,0.107392,0.107549
9,14,23,29222,352836,382058,0.001938,0.012947,0.014885
9,14,23,7050,167783,174833,0.000539,0.006378,0.006917
10,13,23,12653,214262,226915,0.000946,0.007872,0.008818
9,14,23,3396,221348,224744,0.000242,0.008420,0.008662
10,13,23,24232,4738,28970,0.001808,0.000267,0.002075
8,15,23,689,251287,251976,0.000052,0.009503,0.009555
10,16,26,73608,1402345,1475953,0.004279,0.053148,0.057427
10,15,25,23365,1547221,1570586,0.001779,0.051006,0.052785
10,14,24,13045,248189,261234,0.001020,0.009917,0.010937
10,15,25,6856,2293550,2300406,0.000573,0.088228,0.088801
9,14,23,2390,4065203,4067593,0.000211,0.157262,0.157473
9,14,23,6678,1236153,1242831,0.000530,0.048611,0.049141
10,14,24,15626,620300,635926,0.001310,0.022678,0.023988
9,13,22,6098,216276,222374,0.000530,0.010772,0.011302
10,13,23,23228,14789,38017,0.001889,0.001168,0.003057
8,14,22,4321,169438,173759,0.000329,0.008839,0.009168
10,15,25,45605,5627540,5673145,0.003164,0.222154,0.225318
9,15,24,6864,151700,158564,0.000593,0.006247,0.006840
10,14,24,49831,53697,103528,0.003267,0.002933,0.006200
10,13,23,13345,13507,26852,0.000955,0.000713,0.001668
9,15,24,5591,2415061,2420652,0.000423,0.090083,0.090506
9,14,23,9137,1322872,1332009,0.000687,0.046335,0.047022
10,15,25,20889,332221,353110,0.001494,0.012827,0.014321
10,15,25,14133,2260245,2274378,0.001129,0.077527,0.078656
10,13,23,7977,239703,247680,0.000627,0.008848,0.009475
9,14,23,9824,195949,205773,0.000686,0.007200,0.007886
10,13,23,52408,87247,139655,0.003534,0.004014,0.007548
10,14,24,41909,1657120,1699029,0.002859,0.056246,0.059105
9,13,22,8663,25291,33954,0.000654,0.001123,0.001777
9,14,23,2518,567940,570458,0.000193,0.020914,0.021107
10,13,23,107126,239713,346839,0.006671,0.009909,0.016580
9,15,24,1000,271844,272844,0.000089,0.011435,0.011524
10,14,24,36396,2230143,2266539,0.002646,0.087155,0.089801
10,15,25,23777,601056,624833,0.001636,0.027236,0.028872
10,15,25,13601,1951094,1964695,0.001083,0.069993,0.071076
11,14,25,97419,227878,325297,0.006580,0.008876,0.015456
10,15,25,7132,257094,264226,0.000551,0.009513,0.010064
9,15,24,3090,514313,517403,0.000239,0.019649,0.019888
10,14,24,17680,170036,187716,0.001397,0.007248,0.008645
8,14,22,629,1063829,1064458,0.000065,0.039025,0.039090
10,14,24,9265,3618553,3627818,0.000759,0.142176,0.142935
8,14,22,1125,1263457,1264582,0.000095,0.042551,0.042646
10,13,23,23113,157948,181061,0.001735,0.006577,0.008312
10,13,23,11809,69396,81205,0.000960,0.003325,0.004285
10,15,25,17634,5522833,5540467,0.001253,0.187039,0.188292
10,15,25,26019,1055614,1081633,0.002234,0.042748,0.044982
10,15,25,18750,680632,699382,0.001385,0.025818,0.027203
10,14,24,64000,104801,168801,0.004370,0.004889,0.009259
9,14,23,3036,92504,95540,0.000238,0.004366,0.004604
9,13,22,1446,76774,78220,0.000158,0.003523,0.003681
10,14,24,41894,72063,113957,0.002683,0.003783,0.006466
9,14,23,4295,772660,776955,0.000368,0.029329,0.029697
8,15,23,2842,173314,176156,0.000295,0.007877,0.008172
10,14,24,44884,624687,669571,0.003242,0.025400,0.028642
10,13,23,34161,119444,153605,0.002488,0.004873,0.007361
10,14,24,15468,783131,798599,0.001172,0.030566,0.031738
10,14,24,30605,73720,104325,0.002109,0.003224,0.005333
10,14,24,35503,146183,181686,0.002540,0.006208,0.008748
10,15,25,13075,811800,824875,0.000958,0.029984,0.030942
9,12,21,15357,39744,55101,0.001241,0.001814,0.003055
9,14,23,2197,418886,421083,0.000207,0.015947,0.016154
10,14,24,22562,693807,716369,0.001827,0.025675,0.027502
9,13,22,9896,41314,51210,0.000904,0.001846,0.002750
9,15,24,2103,1619097,1621200,0.000184,0.055216,0.055400
10,14,24,6964,12776,19740,0.000642,0.000909,0.001551
10,14,24,14285,1448620,1462905,0.001187,0.052393,0.053580
10,15,25,20023,1878002,1898025,0.001605,0.069426,0.071031
9,14,23,1694,171326,173020,0.000200,0.006412,0.006612
10,15,25,12190,423442,435632,0.000932,0.016609,0.017541
10,15,25,70911,987449,1058360,0.004514,0.039713,0.044227
10,12,22,31671,12890,44561,0.002402,0.000845,0.003247
7,14,21,577,214380,214957,0.000057,0.008591,0.008648
9,14,23,7161,1941795,1948956,0.000574,0.065494,0.066068
10,15,25,37225,802453,839678,0.002727,0.029570,0.032297
10,15,25,77768,1059454,1137222,0.004875,0.043958,0.048833
10,14,24,16747,559584,576331,0.001414,0.027803,0.029217
10,14,24,26505,101743,128248,0.002113,0.004346,0.006459
9,11,20,3695,4701,8396,0.000295,0.000301,0.000596
9,14,23,1863,9551220,9553083,0.000161,0.298645,0.298806
10,11,21,20659,1671,22330,0.001322,0.000114,0.001436
10,15,25,35782,461245,497027,0.002658,0.018043,0.020701
9,14,23,4098,139017,143115,0.000405,0.005682,0.006087
8,14,22,2599,1349393,1351992,0.000221,0.044765,0.044986
10,15,25,18386,900145,918531,0.001443,0.033635,0.035078
9,12,21,3441,14835,18276,0.000334,0.000830,0.001164
10,13,23,89310,20755,110065,0.005771,0.001044,0.006815
11,15,26,91145,4216145,4307290,0.005204,0.150736,0.155940
10,14,24,7447,135322,142769,0.000668,0.005592,0.006260
9,15,24,1138,1986632,1987770,0.000113,0.073145,0.073258
10,14,24,54616,1704891,1759507,0.003792,0.062483,0.066275
9,14,23,6564,675036,681600,0.000571,0.023199,0.023770
10,13,23,11392,12256,23648,0.000947,0.000624,0.001571
9,14,23,16221,13173,29394,0.001176,0.000968,0.002144
10,13,23,29423,74086,103509,0.002052,0.003742,0.005794
10,14,24,24479,99962,124441,0.001716,0.004539,0.006255
9,13,22,5216,111399,116615,0.000411,0.004491,0.004902
10,14,24,8607,329810,338417,0.000703,0.013368,0.014071
9,13,22,8469,19703,28172,0.000670,0.001075,0.001745
10,16,26,39792,3553006,3592798,0.002667,0.134621,0.137288
10,12,22,72277,36065,108342,0.004490,0.001837,0.006327
9,16,25,7262,4587825,4595087,0.000526,0.168642,0.169168
10,14,24,30851,184609,215460,0.002220,0.007545,0.009765
10,14,24,43187,1864970,1908157,0.003173,0.062350,0.065523
10,12,22,11907,2449,14356,0.000999,0.000197,0.001196
8,15,23,637,948585,949222,0.000068,0.041694,0.041762
9,14,23,2041,977218,979259,0.000236,0.035330,0.035566
10,13,23,17102,147379,164481,0.001400,0.005548,0.006948
10,15,25,24137,896689,920826,0.001714,0.031961,0.033675
9,12,21,3091,105027,108118,0.000328,0.004160,0.004488
10,15,25,8960,796243,805203,0.000711,0.028450,0.029161
10,14,24,44542,355402,399944,0.002620,0.013857,0.016477
9,15,24,12979,466410,479389,0.001034,0.017749,0.018783
11,14,25,92860,1301422,1394282,0.005919,0.044441,0.050360
9,13,22,828,213800,214628,0.000112,0.008625,0.008737
10,14,24,16097,107969,124066,0.001249,0.005579,0.006828
8,14,22,1756,1805692,1807448,0.000176,0.061438,0.061614
10,13,23,39927,279837,319764,0.002950,0.010630,0.013580
8,16,24,248,2308890,2309138,0.000027,0.087046,0.087073
10,15,25,42105,689288,731393,0.003060,0.027505,0.030565
10,15,25,20815,571145,591960,0.001609,0.020518,0.022127
9,14,23,3388,296091,299479,0.000320,0.011123,0.011443
9,14,23,3913,328832,332745,0.000358,0.012978,0.013336
10,15,25,13103,3437408,3450511,0.001020,0.128875,0.129895
10,14,24,14807,197330,212137,0.001198,0.007672,0.008870
9,16,25,9525,1877298,1886823,0.000760,0.075692,0.076452
9,15,24,9667,1086174,1095841,0.000816,0.040384,0.041200
7,15,22,206,682210,682416,0.000019,0.029972,0.029991
9,15,24,2604,516742,519346,0.000266,0.027160,0.027426
9,15,24,1587,1848936,1850523,0.000184,0.073614,0.073798
10,15,25,15304,1953322,1968626,0.001355,0.079984,0.081339
10,14,24,16910,392574,409484,0.001388,0.016458,0.017846
10,15,25,10163,1524947,1535110,0.000791,0.055042,0.055833
10,15,25,47360,1019046,1066406,0.003285,0.040027,0.043312
10,15,25,33571,10981683,11015254,0.002543,0.342283,0.344826
10,15,25,19162,213554,232716,0.001532,0.008812,0.010344
10,15,25,16306,1242725,1259031,0.001246,0.057510,0.058756
9,14,23,6125,100096,106221,0.000566,0.004323,0.004889
10,16,26,21677,3925590,3947267,0.001920,0.161906,0.163826
10,14,24,18269,223549,241818,0.001292,0.009353,0.010645
9,13,22,22471,1085,23556,0.001566,0.000101,0.001667
11,13,24,72600,5174,77774,0.004619,0.000273,0.004892
10,14,24,30123,652942,683065,0.001984,0.024005,0.025989
9,15,24,18495,134803,153298,0.001289,0.005845,0.007134
8,11,19,1524,9193,10717,0.000122,0.000428,0.000550
10,14,24,25737,168500,194237,0.001852,0.006623,0.008475
9,14,23,853,7533795,7534648,0.000091,0.262500,0.262591
9,15,24,10118,2796634,2806752,0.000854,0.100183,0.101037
8,14,22,545,223262,223807,0.000073,0.008975,0.009048
10,10,20,12990,966,13956,0.000998,0.000058,0.001056
10,13,23,20019,158400,178419,0.001412,0.006330,0.007742
10,15,25,37194,4778112,4815306,0.002743,0.173135,0.175878
10,14,24,16428,64976,81404,0.001290,0.002836,0.004126
10,15,25,20077,939665,959742,0.001441,0.040096,0.041537
9,14,23,5750,275675,281425,0.000514,0.012513,0.013027
10,14,24,25060,80962,106022,0.001753,0.003761,0.005514
10,16,26,16087,3393033,3409120,0.001244,0.137891,0.139135
9,14,23,12884,90784,103668,0.000981,0.004190,0.005171
11,13,24,79508,315210,394718,0.005609,0.013411,0.019020
8,14,22,398,199577,199975,0.000056,0.008796,0.008852
10,14,24,44896,880706,925602,0.003194,0.033694,0.036888
10,13,23,47671,193933,241604,0.003405,0.007617,0.011022
9,13,22,4411,384664,389075,0.000376,0.014318,0.014694
10,12,22,25887,79389,105276,0.001799,0.003215,0.005014
9,15,24,808,2610282,2611090,0.000083,0.091046,0.091129
9,13,22,10279,19788,30067,0.000877,0.000819,0.001696
9,15,24,1851,1140827,1142678,0.000167,0.040750,0.040917
10,14,24,61703,655779,717482,0.004051,0.024269,0.028320
10,13,23,15142,224989,240131,0.001131,0.008675,0.009806
10,15,25,45164,6128754,6173918,0.003129,0.219833,0.222962
10,15,25,15957,1698047,1714004,0.001240,0.062758,0.063998
9,12,21,889,26288,27177,0.000122,0.001145,0.001267
9,15,24,18460,429654,448114,0.001296,0.018026,0.019322
10,12,22,55255,3231,58486,0.003820,0.000195,0.004015
10,14,24,3961,281967,285928,0.000334,0.011121,0.011455
10,12,22,19060,782,19842,0.001408,0.000069,0.001477
9,15,24,2397,328934,331331,0.000212,0.013968,0.014180
9,14,23,6112,488856,494968,0.000530,0.017134,0.017664
9,13,22,20070,22881,42951,0.001351,0.001208,0.002559
10,16,26,14976,5530864,5545840,0.001113,0.211170,0.212283
11,15,26,94190,895792,989982,0.006184,0.032681,0.038865
10,15,25,20300,782039,802339,0.001527,0.029331,0.030858
8,15,23,1400,609968,611368,0.000160,0.025780,0.025940
9,14,23,9870,470588,480458,0.000808,0.017766,0.018574
10,13,23,13428,51263,64691,0.001094,0.002493,0.003587
10,16,26,18885,1822931,1841816,0.001441,0.070784,0.072225
9,14,23,1153,1180580,1181733,0.000142,0.041234,0.041376
9,13,22,6572,96580,103152,0.000569,0.004226,0.004795
10,13,23,28829,167979,196808,0.002248,0.006848,0.009096
10,12,22,24771,31533,56304,0.001853,0.001596,0.003449
9,15,24,3421,1200810,1204231,0.000258,0.045112,0.045370
9,14,23,973,206400,207373,0.000133,0.008316,0.008449
10,14,24,7884,2779555,2787439,0.000636,0.096599,0.097235
9,15,24,10780,589390,600170,0.000919,0.023527,0.024446
9,14,23,10662,441057,451719,0.000688,0.017190,0.017878
10,14,24,5189,969815,975004,0.000488,0.041177,0.041665
9,15,24,879,378932,379811,0.000092,0.016015,0.016107
9,15,24,8300,7999000,8007300,0.000611,0.280672,0.281283
9,13,22,2002,89887,91889,0.000222,0.003747,0.003969
9,12,21,6958,42787,49745,0.000541,0.001674,0.002215
10,14,24,22803,726658,749461,0.001735,0.026982,0.028717
10,13,23,44126,581695,625821,0.003276,0.020125,0.023401
9,14,23,4431,654096,658527,0.000414,0.023668,0.024082
10,15,25,13783,3340995,3354778,0.001173,0.117540,0.118713
10,13,23,17800,14252,32052,0.001469,0.000856,0.002325
10,14,24,37062,121568,158630,0.002553,0.005060,0.007613
9,15,24,685,649626,650311,0.000073,0.024828,0.024901
9,12,21,12409,38816,51225,0.001012,0.001672,0.002684
10,15,25,24506,636738,661244,0.001737,0.025439,0.027176
10,12,22,7957,93531,101488,0.000727,0.004050,0.004777
10,13,23,43111,267347,310458,0.003001,0.009873,0.012874
10,14,24,21775,504019,525794,0.001551,0.017903,0.019454
10,13,23,24459,6885,31344,0.001799,0.000315,0.002114
10,14,24,34120,611526,645646,0.002261,0.024100,0.026361
9,12,21,2064,2549,4613,0.000223,0.000203,0.000426
9,15,24,2446,5341513,5343959,0.000252,0.175796,0.176048
10,15,25,33036,1430644,1463680,0.002521,0.052022,0.054543
10,14,24,14836,744821,759657,0.001211,0.026660,0.027871
9,14,23,6807,596855,603662,0.000570,0.021336,0.021906
9,14,23,1207,254288,255495,0.000155,0.010360,0.010515
10,14,24,37752,14570,52322,0.002620,0.001215,0.003835
9,14,23,12151,215694,227845,0.000840,0.009128,0.009968
9,15,24,9803,239146,248949,0.000827,0.010795,0.011622
10,13,23,6598,431750,438348,0.000626,0.014015,0.014641
10,15,25,36228,1685923,1722151,0.002651,0.075040,0.077691
9,14,23,2433,4506055,4508488,0.000280,0.137742,0.138022
10,14,24,17059,504729,521788,0.001340,0.018555,0.019895
11,14,25,97700,503967,601667,0.006616,0.019733,0.026349
9,14,23,2536,335001,337537,0.000294,0.013453,0.013747
9,15,24,7876,2580054,2587930,0.000701,0.088941,0.089642
9,11,20,8428,6816,15244,0.000698,0.000380,0.001078
9,14,23,7933,1355197,1363130,0.000658,0.045624,0.046282
9,12,21,12548,10051,22599,0.001062,0.000516,0.001578
10,14,24,20095,664052,684147,0.001576,0.026226,0.027802
10,13,23,8451,154043,162494,0.000760,0.005890,0.006650
8,14,22,487,1525078,1525565,0.000057,0.052888,0.052945
10,14,24,21560,339771,361331,0.001657,0.013309,0.014966
9,13,22,6877,106158,113035,0.000534,0.004259,0.004793
10,15,25,48601,5066226,5114827,0.003353,0.175220,0.178573
9,13,22,10866,62337,73203,0.000866,0.002448,0.003314
9,14,23,4226,604343,608569,0.000387,0.023853,0.024240
8,14,22,1593,336538,338131,0.000171,0.012872,0.013043
10,13,23,11328,325354,336682,0.001000,0.011139,0.012139
11,13,24,129307,163954,293261,0.008421,0.006608,0.015029
10,15,25,11874,363657,375531,0.000975,0.016556,0.017531
10,15,25,8114,2966764,2974878,0.000726,0.105594,0.106320
10,14,24,14392,886816,901208,0.001241,0.031054,0.032295
9,13,22,9895,145310,155205,0.000763,0.005630,0.006393
9,15,24,1714,1595012,1596726,0.000173,0.061190,0.061363
10,13,23,36137,96343,132480,0.002671,0.004495,0.007166
10,14,24,13526,423519,437045,0.000975,0.016904,0.017879
9,13,22,4064,119814,123878,0.000373,0.006198,0.006571
10,15,25,35190,766932,802122,0.002775,0.031256,0.034031
9,14,23,2863,1007446,1010309,0.000289,0.037079,0.037368
9,15,24,18243,3124866,3143109,0.001307,0.109532,0.110839
10,14,24,52798,325316,378114,0.003840,0.012580,0.016420
9,14,23,5321,283611,288932,0.000502,0.011747,0.012249
10,13,23,51134,114222,165356,0.003578,0.005144,0.008722
10,14,24,20965,2147274,2168239,0.001477,0.074927,0.076404
9,13,22,3757,1920,5677,0.000370,0.000160,0.000530
10,15,25,44310,327695,372005,0.002344,0.014042,0.016386
9,16,25,2196,3083206,3085402,0.000226,0.116216,0.116442
9,13,22,1256,515618,516874,0.000160,0.018277,0.018437
8,15,23,837,980319,981156,0.000111,0.037838,0.037949
8,13,21,784,3238,4022,0.000102,0.000239,0.000341
9,14,23,2336,334937,337273,0.000236,0.011698,0.011934
9,13,22,4589,146530,151119,0.000412,0.006104,0.006516
10,14,24,15543,647540,663083,0.001251,0.024400,0.025651
8,14,22,1505,129877,131382,0.000165,0.006413,0.006578
9,15,24,6383,352370,358753,0.000527,0.015333,0.015860
9,14,23,2743,1162224,1164967,0.000248,0.042449,0.042697
9,13,22,9545,307957,317502,0.000822,0.011630,0.012452
10,15,25,38490,1602589,1641079,0.002910,0.059523,0.062433
10,12,22,23259,16716,39975,0.001827,0.000768,0.002595
10,15,25,57456,240787,298243,0.003547,0.010339,0.013886
10,9,19,31093,1197,32290,0.002108,0.000081,0.002189
10,13,23,51795,27326,79121,0.003430,0.002065,0.005495
7,15,22,158,532692,532850,0.000008,0.022925,0.022933
10,13,23,131111,442948,574059,0.008007,0.016223,0.024230
10,13,23,36626,11631,48257,0.002484,0.000666,0.003150
10,12,22,18770,24585,43355,0.001297,0.001352,0.002649
10,13,23,84151,314741,398892,0.005436,0.011759,0.017195
10,15,25,33337,372002,405339,0.002247,0.016259,0.018506
10,13,23,16658,647917,664575,0.001331,0.023421,0.024752
10,15,25,11114,1076914,1088028,0.000815,0.040500,0.041315
9,14,23,6904,103633,110537,0.000596,0.004172,0.004768
10,13,23,14481,58415,72896,0.001094,0.002414,0.003508
9,14,23,4421,12938,17359,0.000352,0.000930,0.001282
9,12,21,11974,240913,252887,0.000909,0.008221,0.009130
8,15,23,273,4700880,4701153,0.000031,0.179779,0.179810
9,13,22,9602,56468,66070,0.000755,0.002525,0.003280
10,13,23,28577,32376,60953,0.002070,0.001535,0.003605
10,13,23,20783,149775,170558,0.001543,0.005964,0.007507
10,13,23,43523,131055,174578,0.002755,0.005247,0.008002
11,14,25,103078,117650,220728,0.006480,0.004671,0.011151
10,14,24,26884,331322,358206,0.001778,0.012692,0.014470
9,15,24,5949,1994774,2000723,0.000504,0.069106,0.069610
10,14,24,17446,387989,405435,0.001412,0.014390,0.015802
10,13,23,41884,81268,123152,0.003175,0.004043,0.007218
9,12,21,3567,25414,28981,0.000284,0.001290,0.001574
10,13,23,35181,26425,61606,0.002577,0.001460,0.004037
10,13,23,16232,160763,176995,0.001143,0.006695,0.007838
10,13,23,19400,32475,51875,0.001426,0.001706,0.003132
10,13,23,17612,101738,119350,0.001307,0.004797,0.006104
9,13,22,3801,132796,136597,0.000287,0.004734,0.005021
10,15,25,11407,3298481,3309888,0.000893,0.121484,0.122377
10,13,23,8895,5128,14023,0.000791,0.000374,0.001165
10,14,24,19060,418800,437860,0.001330,0.016790,0.018120
9,14,23,10408,915197,925605,0.000852,0.032230,0.033082
8,14,22,740,47599,48339,0.000098,0.001955,0.002053
10,12,22,40631,1340,41971,0.002906,0.000119,0.003025
9,15,24,4300,1430881,1435181,0.000325,0.055011,0.055336
10,12,22,35694,108436,144130,0.002393,0.004187,0.006580
10,13,23,85278,301,85579,0.005723,0.000031,0.005754
10,13,23,30806,28878,59684,0.001797,0.001412,0.003209
10,16,26,10637,8416853,8427490,0.000762,0.317187,0.317949
9,13,22,5251,10606,15857,0.000492,0.000709,0.001201
10,14,24,54052,1092077,1146129,0.003546,0.038130,0.041676
10,15,25,12037,2665163,2677200,0.001000,0.097458,0.098458
10,15,25,15551,713830,729381,0.001263,0.027073,0.028336
8,13,21,2614,382205,384819,0.000217,0.013968,0.014185
10,13,23,36468,95409,131877,0.002818,0.004438,0.007256
9,14,23,5646,1409526,1415172,0.000489,0.057888,0.058377
11,14,25,156858,864538,1021396,0.009487,0.031293,0.040780
10,15,25,39141,1310277,1349418,0.002871,0.055302,0.058173
10,14,24,134416,165794,300210,0.007755,0.006402,0.014157
10,15,25,15790,2214764,2230554,0.001144,0.078634,0.079778
10,12,22,12829,140527,153356,0.001060,0.005019,0.006079
9,12,21,3891,12354,16245,0.000335,0.000649,0.000984
10,14,24,43067,174657,217724,0.002867,0.007610,0.010477
9,13,22,8488,31395,39883,0.000685,0.001518,0.002203
11,14,25,121343,3851465,3972808,0.007524,0.124268,0.131792
10,15,25,38697,1494874,1533571,0.002682,0.053733,0.056415
10,13,23,14850,110559,125409,0.001316,0.004333,0.005649
9,16,25,7062,3610650,3617712,0.000594,0.139155,0.139749
10,13,23,22937,18198,41135,0.001717,0.001008,0.002725
9,13,22,18585,286360,304945,0.001288,0.011349,0.012637
10,15,25,44241,511522,555763,0.003103,0.021692,0.024795
9,11,20,10883,11307,22190,0.000865,0.000570,0.001435
10,15,25,61296,337645,398941,0.003748,0.014261,0.018009
8,13,21,3768,74098,77866,0.000331,0.002590,0.002921
9,15,24,2637,213582,216219,0.000241,0.009212,0.009453
9,15,24,14992,2379775,2394767,0.001074,0.089208,0.090282
10,12,22,13229,7242,20471,0.001074,0.000414,0.001488
9,16,25,1800,5383076,5384876,0.000225,0.208553,0.208778
9,14,23,2212,190310,192522,0.000203,0.007024,0.007227
8,15,23,496,2563669,2564165,0.000044,0.093284,0.093328
10,14,24,10144,420988,431132,0.000794,0.014751,0.015545
9,16,25,7188,7585647,7592835,0.000568,0.271942,0.272510
9,15,24,6123,433510,439633,0.000513,0.015000,0.015513
9,14,23,3364,599143,602507,0.000298,0.020286,0.020584
9,15,24,8745,1674082,1682827,0.000697,0.055374,0.056071
10,13,23,17975,23967,41942,0.001323,0.001178,0.002501
10,13,23,35758,46397,82155,0.002278,0.002022,0.004300
10,14,24,51175,4738818,4789993,0.003405,0.164466,0.167871
9,14,23,4705,245095,249800,0.000381,0.009823,0.010204
10,14,24,29344,209830,239174,0.002132,0.009852,0.011984
8,15,23,888,3341016,3341904,0.000087,0.136915,0.137002
10,14,24,77427,254859,332286,0.005343,0.012129,0.017472
9,13,22,7480,25795,33275,0.000615,0.001511,0.002126
10,15,25,53471,672636,726107,0.004495,0.027094,0.031589
10,14,24,14470,1177494,1191964,0.001059,0.039729,0.040788
10,15,25,63587,430106,493693,0.004083,0.016411,0.020494
9,12,21,10404,21684,32088,0.000817,0.000929,0.001746
9,12,21,4306,41241,45547,0.000333,0.001752,0.002085
10,16,26,77063,3845086,3922149,0.005126,0.145224,0.150350
9,11,20,9396,26421,35817,0.000774,0.001025,0.001799
8,15,23,796,1157460,1158256,0.000062,0.040785,0.040847
10,14,24,9916,269044,278960,0.000788,0.010080,0.010868
9,15,24,7886,4739466,4747352,0.000628,0.165693,0.166321
9,15,24,741,1080527,1081268,0.000076,0.047072,0.047148
9,15,24,8176,1113412,1121588,0.000666,0.045063,0.045729
8,14,22,1658,599254,600912,0.000156,0.022065,0.022221
8,13,21,1731,434967,436698,0.000154,0.015293,0.015447
10,15,25,16227,364854,381081,0.001316,0.012607,0.013923
8,13,21,3342,114765,118107,0.000250,0.004542,0.004792
9,13,22,10628,75706,86334,0.000800,0.002923,0.003723
10,15,25,35162,1871288,1906450,0.002564,0.067410,0.069974
9,13,22,6410,78411,84821,0.000540,0.002996,0.003536
10,14,24,45919,1414920,1460839,0.003516,0.048390,0.051906
10,16,26,5056,2875155,2880211,0.000409,0.123805,0.124214
8,13,21,392,62428,62820,0.000039,0.003542,0.003581
10,16,26,12003,3098826,3110829,0.000991,0.162202,0.163193
10,13,23,16254,695,16949,0.001300,0.000073,0.001373
9,16,25,10752,1745904,1756656,0.000789,0.078790,0.079579
9,13,22,2628,197483,200111,0.000210,0.008804,0.009014
10,15,25,8452,2663319,2671771,0.000702,0.100601,0.101303
9,15,24,1981,1297368,1299349,0.000186,0.045719,0.045905
10,12,22,23487,16758,40245,0.001743,0.000720,0.002463
10,14,24,31816,493535,525351,0.002158,0.018242,0.020400
10,14,24,15546,864630,880176,0.001254,0.031851,0.033105
9,15,24,16244,3463433,3479677,0.001193,0.138220,0.139413
10,15,25,9162,415483,424645,0.000744,0.015738,0.016482
9,14,23,7885,213738,221623,0.000633,0.008343,0.008976
9,14,23,3842,1311969,1315811,0.000317,0.043850,0.044167
8,14,22,1136,1904046,1905182,0.000117,0.065201,0.065318
9,15,24,5202,761543,766745,0.000452,0.027945,0.028397
9,12,21,8319,68096,76415,0.000692,0.002637,0.003329
9,14,23,2260,170438,172698,0.000192,0.006697,0.006889
10,14,24,7993,699660,707653,0.000660,0.025603,0.026263
10,14,24,7862,516781,524643,0.000664,0.018468,0.019132
9,15,24,1660,3007888,3009548,0.000158,0.106569,0.106727
9,14,23,29222,352836,382058,0.001959,0.013125,0.015084
9,14,23,7050,167783,174833,0.000550,0.006652,0.007202
10,13,23,12653,214262,226915,0.000969,0.008117,0.009086
9,14,23,3396,221348,224744,0.000244,0.008411,0.008655
10,13,23,24232,4738,28970,0.001820,0.000268,0.002088
8,15,23,689,251287,251976,0.000052,0.009511,0.009563
10,16,26,73608,1402345,1475953,0.004380,0.053610,0.057990
10,15,25,23365,1547221,1570586,0.001935,0.051875,0.053810
10,14,24,13045,248189,261234,0.001029,0.010067,0.011096
10,15,25,6856,2293550,2300406,0.000584,0.091167,0.091751
9,14,23,2390,4065203,4067593,0.000211,0.135580,0.135791
9,14,23,6678,1236153,1242831,0.000518,0.041912,0.042430
10,14,24,15626,620300,635926,0.001206,0.020070,0.021276
9,13,22,6098,216276,222374,0.000482,0.008056,0.008538
10,13,23,23228,14789,38017,0.001812,0.001021,0.002833
8,14,22,4321,169438,173759,0.000315,0.006469,0.006784
10,15,25,45605,5627540,5673145,0.003065,0.202850,0.205915
9,15,24,6864,151700,158564,0.000592,0.006514,0.007106
10,14,24,49831,53697,103528,0.003280,0.002911,0.006191
10,13,23,13345,13507,26852,0.000940,0.000711,0.001651
9,15,24,5591,2415061,2420652,0.000426,0.090009,0.090435
9,14,23,9137,1322872,1332009,0.000689,0.043903,0.044592
10,15,25,20889,332221,353110,0.001499,0.012730,0.014229
10,15,25,14133,2260245,2274378,0.001153,0.078029,0.079182
10,13,23,7977,239703,247680,0.000636,0.008944,0.009580
9,14,23,9824,195949,205773,0.000686,0.007190,0.007876
10,13,23,52408,87247,139655,0.003574,0.003996,0.007570
10,14,24,41909,1657120,1699029,0.003050,0.056380,0.059430
9,13,22,8663,25291,33954,0.000666,0.001109,0.001775
9,14,23,2518,567940,570458,0.000197,0.021426,0.021623
10,13,23,107126,239713,346839,0.006781,0.009260,0.016041
9,15,24,1000,271844,272844,0.000087,0.010672,0.010759
10,14,24,36396,2230143,2266539,0.002559,0.079194,0.081753
10,15,25,23777,601056,624833,0.001610,0.026470,0.028080
10,15,25,13601,1951094,1964695,0.001082,0.087270,0.088352
11,14,25,97419,227878,325297,0.006630,0.009026,0.015656
10,15,25,7132,257094,264226,0.000547,0.009572,0.010119
9,15,24,3090,514313,517403,0.000244,0.019805,0.020049
10,14,24,17680,170036,187716,0.001413,0.006695,0.008108
8,14,22,629,1063829,1064458,0.000057,0.034659,0.034716
10,14,24,9265,3618553,3627818,0.000823,0.123442,0.124265
8,14,22,1125,1263457,1264582,0.000105,0.043171,0.043276
10,13,23,23113,157948,181061,0.001744,0.006537,0.008281
10,13,23,11809,69396,81205,0.000956,0.003274,0.004230
10,15,25,17634,5522833,5540467,0.001270,0.187282,0.188552
10,15,25,26019,1055614,1081633,0.002039,0.043066,0.045105
10,15,25,18750,680632,699382,0.001400,0.026102,0.027502
10,14,24,64000,104801,168801,0.004480,0.005033,0.009513
9,14,23,3036,92504,95540,0.000237,0.004415,0.004652
9,13,22,1446,76774,78220,0.000161,0.003508,0.003669
10,14,24,41894,72063,113957,0.002682,0.003689,0.006371
9,14,23,4295,772660,776955,0.000371,0.029338,0.029709
8,15,23,2842,173314,176156,0.000296,0.007931,0.008227
10,14,24,44884,624687,669571,0.003360,0.024945,0.028305
10,13,23,34161,119444,153605,0.002479,0.004852,0.007331
10,14,24,15468,783131,798599,0.001180,0.030827,0.032007
10,14,24,30605,73720,104325,0.002095,0.003246,0.005341
10,14,24,35503,146183,181686,0.002500,0.006215,0.008715
10,15,25,13075,811800,824875,0.000978,0.030203,0.031181
9,12,21,15357,39744,55101,0.001190,0.001847,0.003037
9,14,23,2197,418886,421083,0.000229,0.015673,0.015902
10,14,24,22562,693807,716369,0.001898,0.029636,0.031534
9,13,22,9896,41314,51210,0.000859,0.002011,0.002870
9,15,24,2103,1619097,1621200,0.000181,0.059360,0.059541
10,14,24,6964,12776,19740,0.000614,0.000967,0.001581
10,14,24,14285,1448620,1462905,0.001122,0.058698,0.059820
10,15,25,20023,1878002,1898025,0.001559,0.076378,0.077937
9,14,23,1694,171326,173020,0.000166,0.006887,0.007053
10,15,25,12190,423442,435632,0.000933,0.017375,0.018308
10,15,25,70911,987449,1058360,0.004855,0.039786,0.044641
10,12,22,31671,12890,44561,0.002442,0.000859,0.003301
7,14,21,577,214380,214957,0.000042,0.008493,0.008535
9,14,23,7161,1941795,1948956,0.000556,0.065983,0.066539
10,15,25,37225,802453,839678,0.002723,0.029554,0.032277
10,15,25,77768,1059454,1137222,0.004966,0.041848,0.046814
10,14,24,16747,559584,576331,0.001393,0.024646,0.026039
10,14,24,26505,101743,128248,0.002148,0.004063,0.006211
9,11,20,3695,4701,8396,0.000315,0.000289,0.000604
9,14,23,1863,9551220,9553083,0.000176,0.298831,0.299007
10,11,21,20659,1671,22330,0.001351,0.000116,0.001467
10,15,25,35782,461245,497027,0.002634,0.017989,0.020623
9,14,23,4098,139017,143115,0.000377,0.005721,0.006098
8,14,22,2599,1349393,1351992,0.000228,0.044499,0.044727
10,15,25,18386,900145,918531,0.001534,0.033271,0.034805
9,12,21,3441,14835,18276,0.000335,0.000768,0.001103
10,13,23,89310,20755,110065,0.005909,0.000981,0.006890
11,15,26,91145,4216145,4307290,0.005352,0.151358,0.156710
10,14,24,7447,135322,142769,0.000649,0.005736,0.006385
9,15,24,1138,1986632,1987770,0.000116,0.074896,0.075012
10,14,24,54616,1704891,1759507,0.003923,0.066115,0.070038
9,14,23,6564,675036,681600,0.000619,0.026653,0.027272
10,13,23,11392,12256,23648,0.000927,0.000669,0.001596
9,14,23,16221,13173,29394,0.001169,0.001006,0.002175
10,13,23,29423,74086,103509,0.002039,0.003582,0.005621
10,14,24,24479,99962,124441,0.001678,0.004832,0.006510
9,13,22,5216,111399,116615,0.000459,0.004674,0.005133
10,14,24,8607,329810,338417,0.000718,0.013284,0.014002
9,13,22,8469,19703,28172,0.000675,0.001115,0.001790
10,16,26,39792,3553006,3592798,0.002695,0.155527,0.158222
10,12,22,72277,36065,108342,0.004682,0.001866,0.006548
9,16,25,7262,4587825,4595087,0.000541,0.175199,0.175740
10,14,24,30851,184609,215460,0.002347,0.007407,0.009754
10,14,24,43187,1864970,1908157,0.003286,0.059374,0.062660
10,12,22,11907,2449,14356,0.001021,0.000203,0.001224
8,15,23,637,948585,949222,0.000067,0.040717,0.040784
9,14,23,2041,977218,979259,0.000214,0.034450,0.034664
10,13,23,17102,147379,164481,0.001381,0.005563,0.006944
10,15,25,24137,896689,920826,0.001741,0.032254,0.033995
9,12,21,3091,105027,108118,0.000313,0.004253,0.004566
10,15,25,8960,796243,805203,0.000735,0.033205,0.033940
10,14,24,44542,355402,399944,0.002679,0.015547,0.018226
9,15,24,12979,466410,479389,0.000999,0.019785,0.020784
11,14,25,92860,1301422,1394282,0.006394,0.044460,0.050854
9,13,22,828,213800,214628,0.000121,0.008996,0.009117
10,14,24,16097,107969,124066,0.001291,0.005739,0.007030
8,14,22,1756,1805692,1807448,0.000174,0.067404,0.067578
10,13,23,39927,279837,319764,0.003035,0.010674,0.013709
8,16,24,248,2308890,2309138,0.000031,0.087416,0.087447
10,15,25,42105,689288,731393,0.003084,0.027739,0.030823
10,15,25,20815,571145,591960,0.001723,0.020362,0.022085
9,14,23,3388,296091,299479,0.000318,0.011296,0.011614
9,14,23,3913,328832,332745,0.000368,0.013827,0.014195
10,15,25,13103,3437408,3450511,0.001105,0.132898,0.134003
10,14,24,14807,197330,212137,0.001205,0.007614,0.008819
9,16,25,9525,1877298,1886823,0.000771,0.073671,0.074442
9,15,24,9667,1086174,1095841,0.000836,0.040874,0.041710
7,15,22,206,682210,682416,0.000019,0.029923,0.029942
9,15,24,2604,516742,519346,0.000268,0.021664,0.021932
9,15,24,1587,1848936,1850523,0.000182,0.067005,0.067187
10,15,25,15304,1953322,1968626,0.001241,0.069840,0.071081
10,14,24,16910,392574,409484,0.001420,0.015494,0.016914
10,15,25,10163,1524947,1535110,0.000829,0.053283,0.054112
10,15,25,47360,1019046,1066406,0.003325,0.040692,0.044017
10,15,25,33571,10981683,11015254,0.002580,0.340721,0.343301
10,15,25,19162,213554,232716,0.001555,0.008829,0.010384
10,15,25,16306,1242725,1259031,0.001177,0.050504,0.051681
9,14,23,6125,100096,106221,0.000609,0.004135,0.004744
10,16,26,21677,3925590,3947267,0.001817,0.154526,0.156343
10,14,24,18269,223549,241818,0.001308,0.008880,0.010188
9,13,22,22471,1085,23556,0.001593,0.000104,0.001697
11,13,24,72600,5174,77774,0.004602,0.000283,0.004885
10,14,24,30123,652942,683065,0.002015,0.024477,0.026492
9,15,24,18495,134803,153298,0.001312,0.005731,0.007043
8,11,19,1524,9193,10717,0.000135,0.000421,0.000556
10,14,24,25737,168500,194237,0.001885,0.006523,0.008408
9,14,23,853,7533795,7534648,0.000099,0.257395,0.257494
9,15,24,10118,2796634,2806752,0.000843,0.112780,0.113623
8,14,22,545,223262,223807,0.000073,0.009071,0.009144
10,10,20,12990,966,13956,0.000995,0.000059,0.001054
10,13,23,20019,158400,178419,0.001400,0.006525,0.007925
10,15,25,37194,4778112,4815306,0.002749,0.173072,0.175821
10,14,24,16428,64976,81404,0.001333,0.002842,0.004175
10,15,25,20077,939665,959742,0.001433,0.043969,0.045402
9,14,23,5750,275675,281425,0.000513,0.015534,0.016047
10,14,24,25060,80962,106022,0.002084,0.004301,0.006385
10,16,26,16087,3393033,3409120,0.001282,0.129958,0.131240
9,14,23,12884,90784,103668,0.001006,0.004068,0.005074
11,13,24,79508,315210,394718,0.005192,0.012816,0.018008
8,14,22,398,199577,199975,0.000057,0.007898,0.007955
10,14,24,44896,880706,925602,0.003343,0.037286,0.040629
10,13,23,47671,193933,241604,0.003584,0.008525,0.012109
9,13,22,4411,384664,389075,0.000427,0.015879,0.016306
10,12,22,25887,79389,105276,0.001815,0.003472,0.005287
9,15,24,808,2610282,2611090,0.000097,0.098383,0.098480
9,13,22,10279,19788,30067,0.000912,0.000850,0.001762
9,15,24,1851,1140827,1142678,0.000175,0.040833,0.041008
10,14,24,61703,655779,717482,0.004100,0.024921,0.029021
10,13,23,15142,224989,240131,0.001186,0.008727,0.009913
10,15,25,45164,6128754,6173918,0.003146,0.212879,0.216025
10,15,25,15957,1698047,1714004,0.001224,0.063676,0.064900
9,12,21,889,26288,27177,0.000119,0.001245,0.001364
9,15,24,18460,429654,448114,0.001291,0.020310,0.021601
10,12,22,55255,3231,58486,0.003826,0.000207,0.004033
10,14,24,3961,281967,285928,0.000316,0.011378,0.011694
10,12,22,19060,782,19842,0.001469,0.000068,0.001537
9,15,24,2397,328934,331331,0.000207,0.014695,0.014902
9,14,23,6112,488856,494968,0.000531,0.018700,0.019231
9,13,22,20070,22881,42951,0.001363,0.001220,0.002583
10,16,26,14976,5530864,5545840,0.001168,0.220022,0.221190
11,15,26,94190,895792,989982,0.006178,0.033230,0.039408
10,15,25,20300,782039,802339,0.001563,0.029546,0.031109
8,15,23,1400,609968,611368,0.000161,0.025705,0.025866
9,14,23,9870,470588,480458,0.000801,0.017729,0.018530
10,13,23,13428,51263,64691,0.001174,0.002614,0.003788
10,16,26,18885,1822931,1841816,0.001460,0.077100,0.078560
9,14,23,1153,1180580,1181733,0.000146,0.043724,0.043870
9,13,22,6572,96580,103152,0.000600,0.004270,0.004870
10,13,23,28829,167979,196808,0.002290,0.006931,0.009221
10,12,22,24771,31533,56304,0.001897,0.001571,0.003468
9,15,24,3421,1200810,1204231,0.000270,0.045135,0.045405
9,14,23,973,206400,207373,0.000130,0.008322,0.008452
10,14,24,7884,2779555,2787439,0.000647,0.094781,0.095428
9,15,24,10780,589390,600170,0.000898,0.023952,0.024850
9,14,23,10662,441057,451719,0.000690,0.017567,0.018257
10,14,24,5189,969815,975004,0.000454,0.036325,0.036779
9,15,24,879,378932,379811,0.000123,0.014990,0.015113
9,15,24,8300,7999000,8007300,0.000609,0.281432,0.282041
9,13,22,2002,89887,91889,0.000226,0.003755,0.003981
9,12,21,6958,42787,49745,0.000551,0.001680,0.002231
10,14,24,22803,726658,749461,0.001807,0.026581,0.028388
10,13,23,44126,581695,625821,0.003233,0.020230,0.023463
9,14,23,4431,654096,658527,0.000413,0.024157,0.024570
10,15,25,13783,3340995,3354778,0.001164,0.118621,0.119785
10,13,23,17800,14252,32052,0.001449,0.000869,0.002318
10,14,24,37062,121568,158630,0.002586,0.005083,0.007669
9,15,24,685,649626,650311,0.000084,0.024600,0.024684
9,12,21,12409,38816,51225,0.000980,0.001626,0.002606
10,15,25,24506,636738,661244,0.001775,0.025983,0.027758
10,12,22,7957,93531,101488,0.000726,0.004097,0.004823
10,13,23,43111,267347,310458,0.003083,0.009964,0.013047
10,14,24,21775,504019,525794,0.001654,0.019099,0.020753
10,13,23,24459,6885,31344,0.001800,0.000317,0.002117
10,14,24,34120,611526,645646,0.002371,0.025503,0.027874
9,12,21,2064,2549,4613,0.000191,0.000218,0.000409
9,15,24,2446,5341513,5343959,0.000233,0.209059,0.209292
10,15,25,33036,1430644,1463680,0.002513,0.060571,0.063084
10,14,24,14836,744821,759657,0.001242,0.031444,0.032686
9,14,23,6807,596855,603662,0.000597,0.023629,0.024226
9,14,23,1207,254288,255495,0.000121,0.011561,0.011682
10,14,24,37752,14570,52322,0.002731,0.001264,0.003995
9,14,23,12151,215694,227845,0.000875,0.009318,0.010193
9,15,24,9803,239146,248949,0.000825,0.011021,0.011846
10,13,23,6598,431750,438348,0.000594,0.014577,0.015171
10,15,25,36228,1685923,1722151,0.002624,0.069516,0.072140
9,14,23,2433,4506055,4508488,0.000255,0.141822,0.142077
10,14,24,17059,504729,521788,0.001358,0.018596,0.019954
11,14,25,97700,503967,601667,0.006402,0.019648,0.026050
9,14,23,2536,335001,337537,0.000265,0.013408,0.013673
9,15,24,7876,2580054,2587930,0.000706,0.089658,0.090364
9,11,20,8428,6816,15244,0.000701,0.000383,0.001084
9,14,23,7933,1355197,1363130,0.000680,0.045568,0.046248
9,12,21,12548,10051,22599,0.001029,0.000563,0.001592
10,14,24,20095,664052,684147,0.001584,0.025964,0.027548
10,13,23,8451,154043,162494,0.000785,0.005933,0.006718
8,14,22,487,1525078,1525565,0.000058,0.053565,0.053623
10,14,24,21560,339771,361331,0.001625,0.013495,0.015120
9,13,22,6877,106158,113035,0.000627,0.004429,0.005056
10,15,25,48601,5066226,5114827,0.003384,0.196942,0.200326
9,13,22,10866,62337,73203,0.000862,0.002722,0.003584
9,14,23,4226,604343,608569,0.000384,0.026479,0.026863
8,14,22,1593,336538,338131,0.000140,0.013274,0.013414
10,13,23,11328,325354,336682,0.001027,0.011135,0.012162
11,13,24,129307,163954,293261,0.008581,0.006739,0.015320
10,15,25,11874,363657,375531,0.000975,0.017116,0.018091
10,15,25,8114,2966764,2974878,0.000690,0.107427,0.108117
10,14,24,14392,886816,901208,0.001263,0.030384,0.031647
9,13,22,9895,145310,155205,0.000759,0.005534,0.006293
9,15,24,1714,1595012,1596726,0.000176,0.060918,0.061094
10,13,23,36137,96343,132480,0.002742,0.004556,0.007298
10,14,24,13526,423519,437045,0.001000,0.016687,0.017687
9,13,22,4064,119814,123878,0.000384,0.004771,0.005155
10,15,25,35190,766932,802122,0.002717,0.027590,0.030307
9,14,23,2863,1007446,1010309,0.000313,0.037594,0.037907
9,15,24,18243,3124866,3143109,0.001368,0.110479,0.111847
10,14,24,52798,325316,378114,0.003895,0.012589,0.016484
9,14,23,5321,283611,288932,0.000507,0.012061,0.012568
10,13,23,51134,114222,165356,0.003569,0.005211,0.008780
10,14,24,20965,2147274,2168239,0.001590,0.074854,0.076444
9,13,22,3757,1920,5677,0.000370,0.000160,0.000530
10,15,25,44310,327695,372005,0.002393,0.014920,0.017313
9,16,25,2196,3083206,3085402,0.000208,0.116721,0.116929
9,13,22,1256,515618,516874,0.000159,0.018515,0.018674
8,15,23,837,980319,981156,0.000111,0.037891,0.038002
8,13,21,784,3238,4022,0.000104,0.000241,0.000345
9,14,23,2336,334937,337273,0.000235,0.011716,0.011951
9,13,22,4589,146530,151119,0.000414,0.006218,0.006632
10,14,24,15543,647540,663083,0.001286,0.024853,0.026139
8,14,22,1505,129877,131382,0.000166,0.006418,0.006584
9,15,24,6383,352370,358753,0.000538,0.016103,0.016641
9,14,23,2743,1162224,1164967,0.000264,0.042978,0.043242
9,13,22,9545,307957,317502,0.000834,0.011870,0.012704
10,15,25,38490,1602589,1641079,0.002955,0.068282,0.071237
10,12,22,23259,16716,39975,0.001844,0.000824,0.002668
10,15,25,57456,240787,298243,0.003765,0.010139,0.013904
10,9,19,31093,1197,32290,0.002133,0.000085,0.002218
10,13,23,51795,27326,79121,0.003659,0.002042,0.005701
7,15,22,158,532692,532850,0.000009,0.023242,0.023251
10,13,23,131111,442948,574059,0.008416,0.016379,0.024795
10,13,23,36626,11631,48257,0.002488,0.000727,0.003215
10,12,22,18770,24585,43355,0.001337,0.001344,0.002681
10,13,23,84151,314741,398892,0.005346,0.012196,0.017542
10,15,25,33337,372002,405339,0.002290,0.016984,0.019274
10,13,23,16658,647917,664575,0.001290,0.023654,0.024944
10,15,25,11114,1076914,1088028,0.000857,0.040719,0.041576
9,14,23,6904,103633,110537,0.000603,0.004442,0.005045
10,13,23,14481,58415,72896,0.001085,0.002487,0.003572
9,14,23,4421,12938,17359,0.000352,0.000974,0.001326
9,12,21,11974,240913,252887,0.000923,0.008335,0.009258
8,15,23,273,4700880,4701153,0.000038,0.171995,0.172033
9,13,22,9602,56468,66070,0.000793,0.002435,0.003228
10,13,23,28577,32376,60953,0.002075,0.001492,0.003567
10,13,23,20783,149775,170558,0.001481,0.005890,0.007371
10,13,23,43523,131055,174578,0.002806,0.005321,0.008127
11,14,25,103078,117650,220728,0.006576,0.004760,0.011336
10,14,24,26884,331322,358206,0.001841,0.012620,0.014461
9,15,24,5949,1994774,2000723,0.000581,0.069239,0.069820
10,14,24,17446,387989,405435,0.001503,0.014569,0.016072
10,13,23,41884,81268,123152,0.003210,0.004013,0.007223
9,12,21,3567,25414,28981,0.000285,0.001270,0.001555
10,13,23,35181,26425,61606,0.002614,0.001462,0.004076
10,13,23,16232,160763,176995,0.001153,0.006891,0.008044
10,13,23,19400,32475,51875,0.001421,0.001676,0.003097
10,13,23,17612,101738,119350,0.001315,0.004837,0.006152
9,13,22,3801,132796,136597,0.000287,0.004870,0.005157
10,15,25,11407,3298481,3309888,0.000881,0.122810,0.123691
10,13,23,8895,5128,14023,0.000774,0.000388,0.001162
10,14,24,19060,418800,437860,0.001322,0.016984,0.018306
9,14,23,10408,915197,925605,0.000861,0.032611,0.033472
8,14,22,740,47599,48339,0.000100,0.002004,0.002104
10,12,22,40631,1340,41971,0.003039,0.000118,0.003157
9,15,24,4300,1430881,1435181,0.000339,0.056640,0.056979
10,12,22,35694,108436,144130,0.002385,0.004170,0.006555
10,13,23,85278,301,85579,0.005835,0.000031,0.005866
10,13,23,30806,28878,59684,0.001773,0.001392,0.003165
10,16,26,10637,8416853,8427490,0.000766,0.329857,0.330623
9,13,22,5251,10606,15857,0.000512,0.000679,0.001191
10,14,24,54052,1092077,1146129,0.003541,0.038362,0.041903
10,15,25,12037,2665163,2677200,0.001080,0.096655,0.097735
10,15,25,15551,713830,729381,0.001256,0.027169,0.028425
8,13,21,2614,382205,384819,0.000233,0.014146,0.014379
10,13,23,36468,95409,131877,0.002861,0.004417,0.007278
9,14,23,5646,1409526,1415172,0.000468,0.051751,0.052219
11,14,25,156858,864538,1021396,0.009647,0.030183,0.039830
10,15,25,39141,1310277,1349418,0.002914,0.055164,0.058078
10,14,24,134416,165794,300210,0.007936,0.006410,0.014346
10,15,25,15790,2214764,2230554,0.001196,0.078351,0.079547
10,12,22,12829,140527,153356,0.001066,0.005009,0.006075
9,12,21,3891,12354,16245,0.000321,0.000621,0.000942
10,14,24,43067,174657,217724,0.002705,0.007692,0.010397
9,13,22,8488,31395,39883,0.000717,0.001483,0.002200
11,14,25,121343,3851465,3972808,0.007384,0.124776,0.132160
10,15,25,38697,1494874,1533571,0.002850,0.053464,0.056314
10,13,23,14850,110559,125409,0.001300,0.004366,0.005666
9,16,25,7062,3610650,3617712,0.000627,0.139998,0.140625
10,13,23,22937,18198,41135,0.001715,0.000974,0.002689
9,13,22,18585,286360,304945,0.001317,0.011859,0.013176
10,15,25,44241,511522,555763,0.003322,0.026795,0.030117
9,11,20,10883,11307,22190,0.000839,0.000603,0.001442
10,15,25,61296,337645,398941,0.003762,0.014757,0.018519
8,13,21,3768,74098,77866,0.000337,0.002573,0.002910
9,15,24,2637,213582,216219,0.000244,0.009548,0.009792
9,15,24,14992,2379775,2394767,0.001100,0.089754,0.090854
10,12,22,13229,7242,20471,0.001101,0.000417,0.001518
9,16,25,1800,5383076,5384876,0.000198,0.199766,0.199964
9,14,23,2212,190310,192522,0.000201,0.007166,0.007367
8,15,23,496,2563669,2564165,0.000046,0.094339,0.094385
10,14,24,10144,420988,431132,0.000851,0.015427,0.016278
9,16,25,7188,7585647,7592835,0.000593,0.274976,0.275569
9,15,24,6123,433510,439633,0.000546,0.016251,0.016797
9,14,23,3364,599143,602507,0.000310,0.021091,0.021401
9,15,24,8745,1674082,1682827,0.000746,0.057061,0.057807
10,13,23,17975,23967,41942,0.001423,0.001196,0.002619
10,13,23,35758,46397,82155,0.002616,0.001976,0.004592
10,14,24,51175,4738818,4789993,0.003592,0.168599,0.172191
9,14,23,4705,245095,249800,0.000407,0.008864,0.009271
10,14,24,29344,209830,239174,0.002332,0.008432,0.010764
8,15,23,888,3341016,3341904,0.000074,0.118513,0.118587
10,14,24,77427,254859,332286,0.005894,0.009613,0.015507
9,13,22,7480,25795,33275,0.000598,0.001394,0.001992
10,15,25,53471,672636,726107,0.004184,0.026641,0.030825
10,14,24,14470,1177494,1191964,0.001161,0.038874,0.040035
10,15,25,63587,430106,493693,0.004753,0.017097,0.021850
9,12,21,10404,21684,32088,0.000855,0.000988,0.001843
9,12,21,4306,41241,45547,0.000374,0.001971,0.002345
10,16,26,77063,3845086,3922149,0.006034,0.149764,0.155798
9,11,20,9396,26421,35817,0.000789,0.001041,0.001830
8,15,23,796,1157460,1158256,0.000067,0.041309,0.041376
10,14,24,9916,269044,278960,0.000868,0.011006,0.011874
9,15,24,7886,4739466,4747352,0.000673,0.183024,0.183697
9,15,24,741,1080527,1081268,0.000079,0.042074,0.042153
9,15,24,8176,1113412,1121588,0.000696,0.041657,0.042353
8,14,22,1658,599254,600912,0.000174,0.021924,0.022098
8,13,21,1731,434967,436698,0.000159,0.016287,0.016446
10,15,25,16227,364854,381081,0.001544,0.013209,0.014753
8,13,21,3342,114765,118107,0.000265,0.004840,0.005105
9,13,22,10628,75706,86334,0.000872,0.003018,0.003890
10,15,25,35162,1871288,1906450,0.002894,0.066809,0.069703
9,13,22,6410,78411,84821,0.000579,0.003140,0.003719
10,14,24,45919,1414920,1460839,0.003956,0.049872,0.053828
10,16,26,5056,2875155,2880211,0.000437,0.105972,0.106409
8,13,21,392,62428,62820,0.000041,0.002794,0.002835
10,16,26,12003,3098826,3110829,0.001046,0.123900,0.124946
10,13,23,16254,695,16949,0.001397,0.000057,0.001454
9,16,25,10752,1745904,1756656,0.000848,0.068766,0.069614
9,13,22,2628,197483,200111,0.000215,0.007486,0.007701
10,15,25,8452,2663319,2671771,0.000734,0.094665,0.095399
9,15,24,1981,1297368,1299349,0.000192,0.046434,0.046626
10,12,22,23487,16758,40245,0.001972,0.000729,0.002701
10,14,24,31816,493535,525351,0.002544,0.019321,0.021865
10,14,24,15546,864630,880176,0.001339,0.030693,0.032032
9,15,24,16244,3463433,3479677,0.001333,0.136886,0.138219
10,15,25,9162,415483,424645,0.000805,0.016289,0.017094
9,14,23,7885,213738,221623,0.000665,0.008964,0.009629
9,14,23,3842,1311969,1315811,0.000328,0.044739,0.045067
8,14,22,1136,1904046,1905182,0.000101,0.066334,0.066435
9,15,24,5202,761543,766745,0.000482,0.029462,0.029944
9,12,21,8319,68096,76415,0.000739,0.002729,0.003468
9,14,23,2260,170438,172698,0.000199,0.007026,0.007225
10,14,24,7993,699660,707653,0.000704,0.025644,0.026348
10,14,24,7862,516781,524643,0.000706,0.018932,0.019638
9,15,24,1660,3007888,3009548,0.000160,0.108610,0.108770
9,14,23,29222,352836,382058,0.002277,0.013569,0.015846
9,14,23,7050,167783,174833,0.000563,0.006752,0.007315
10,13,23,12653,214262,226915,0.001049,0.008478,0.009527
9,14,23,3396,221348,224744,0.000253,0.009200,0.009453
10,13,23,24232,4738,28970,0.002033,0.000261,0.002294
8,15,23,689,251287,251976,0.000055,0.009687,0.009742
10,16,26,73608,1402345,1475953,0.005071,0.056071,0.061142
10,15,25,23365,1547221,1570586,0.002022,0.052159,0.054181
10,14,24,13045,248189,261234,0.001129,0.010382,0.011511
10,15,25,6856,2293550,2300406,0.000612,0.085023,0.085635
9,14,23,2390,4065203,4067593,0.000221,0.132338,0.132559
9,14,23,6678,1236153,1242831,0.000561,0.041938,0.042499
10,14,24,15626,620300,635926,0.001311,0.020838,0.022149
9,13,22,6098,216276,222374,0.000518,0.008587,0.009105
10,13,23,23228,14789,38017,0.002000,0.001009,0.003009
8,14,22,4321,169438,173759,0.000356,0.006943,0.007299
10,15,25,45605,5627540,5673145,0.003468,0.217075,0.220543
9,15,24,6864,151700,158564,0.000639,0.006287,0.006926
10,14,24,49831,53697,103528,0.003843,0.002879,0.006722
10,13,23,13345,13507,26852,0.001032,0.000731,0.001763
9,15,24,5591,2415061,2420652,0.000450,0.096045,0.096495
9,14,23,9137,1322872,1332009,0.000742,0.045063,0.045805
10,15,25,20889,332221,353110,0.001654,0.013665,0.015319
10,15,25,14133,2260245,2274378,0.001211,0.079890,0.081101
10,13,23,7977,239703,247680,0.000696,0.009518,0.010214
9,14,23,9824,195949,205773,0.000790,0.007847,0.008637
10,13,23,52408,87247,139655,0.003996,0.004269,0.008265
10,14,24,41909,1657120,1699029,0.003191,0.057806,0.060997
9,13,22,8663,25291,33954,0.000715,0.001111,0.001826
9,14,23,2518,567940,570458,0.000207,0.021512,0.021719
10,13,23,107126,239713,346839,0.007928,0.010102,0.018030
9,15,24,1000,271844,272844,0.000083,0.011107,0.011190
10,14,24,36396,2230143,2266539,0.002770,0.078909,0.081679
10,15,25,23777,601056,624833,0.001954,0.027176,0.029130
10,15,25,13601,1951094,1964695,0.001168,0.070650,0.071818
11,14,25,97419,227878,325297,0.007757,0.009185,0.016942
10,15,25,7132,257094,264226,0.000560,0.010172,0.010732
9,15,24,3090,514313,517403,0.000246,0.020505,0.020751
10,14,24,17680,170036,187716,0.001508,0.006786,0.008294
8,14,22,629,1063829,1064458,0.000055,0.035323,0.035378
10,14,24,9265,3618553,3627818,0.000808,0.124195,0.125003
8,14,22,1125,1263457,1264582,0.000101,0.043480,0.043581
10,13,23,23113,157948,181061,0.002079,0.006815,0.008894
10,13,23,11809,69396,81205,0.001015,0.003489,0.004504
10,15,25,17634,5522833,5540467,0.001408,0.201921,0.203329
10,15,25,26019,1055614,1081633,0.002307,0.045564,0.047871
10,15,25,18750,680632,699382,0.001769,0.027900,0.029669
10,14,24,64000,104801,168801,0.005296,0.004980,0.010276
9,14,23,3036,92504,95540,0.000289,0.005366,0.005655
9,13,22,1446,76774,78220,0.000163,0.003725,0.003888
10,14,24,41894,72063,113957,0.003086,0.003820,0.006906
9,14,23,4295,772660,776955,0.000372,0.030789,0.031161
8,15,23,2842,173314,176156,0.000324,0.008700,0.009024
10,14,24,44884,624687,669571,0.003769,0.027193,0.030962
10,13,23,34161,119444,153605,0.002793,0.004914,0.007707
10,14,24,15468,783131,798599,0.001161,0.031925,0.033086
10,14,24,30605,73720,104325,0.002221,0.003373,0.005594
10,14,24,35503,146183,181686,0.002658,0.006390,0.009048
10,15,25,13075,811800,824875,0.000994,0.031099,0.032093
9,12,21,15357,39744,55101,0.001238,0.001900,0.003138
9,14,23,2197,418886,421083,0.000220,0.016123,0.016343
10,14,24,22562,693807,716369,0.001867,0.025841,0.027708
9,13,22,9896,41314,51210,0.000900,0.001947,0.002847
9,15,24,2103,1619097,1621200,0.000188,0.056757,0.056945
10,14,24,6964,12776,19740,0.000653,0.000948,0.001601
10,14,24,14285,1448620,1462905,0.001193,0.054111,0.055304
10,15,25,20023,1878002,1898025,0.001691,0.070700,0.072391
9,14,23,1694,171326,173020,0.000207,0.007122,0.007329
10,15,25,12190,423442,435632,0.000999,0.017074,0.018073
10,15,25,70911,987449,1058360,0.004980,0.040717,0.045697
10,12,22,31671,12890,44561,0.002576,0.000852,0.003428
7,14,21,577,214380,214957,0.000059,0.008601,0.008660
9,14,23,7161,1941795,1948956,0.000562,0.065707,0.066269
10,15,25,37225,802453,839678,0.002969,0.030540,0.033509
10,15,25,77768,1059454,1137222,0.005333,0.041756,0.047089
10,14,24,16747,559584,576331,0.001421,0.025217,0.026638
10,14,24,26505,101743,128248,0.002170,0.004220,0.006390
9,11,20,3695,4701,8396,0.000294,0.000290,0.000584
9,14,23,1863,9551220,9553083,0.000180,0.310024,0.310204
10,11,21,20659,1671,22330,0.001544,0.000114,0.001658
10,15,25,35782,461245,497027,0.003065,0.019162,0.022227
9,14,23,4098,139017,143115,0.000392,0.006375,0.006767
8,14,22,2599,1349393,1351992,0.000226,0.046704,0.046930
10,15,25,18386,900145,918531,0.001712,0.034642,0.036354
9,12,21,3441,14835,18276,0.000365,0.000876,0.001241
10,13,23,89310,20755,110065,0.007235,0.001007,0.008242
11,15,26,91145,4216145,4307290,0.005934,0.155457,0.161391
10,14,24,7447,135322,142769,0.000720,0.006213,0.006933
9,15,24,1138,1986632,1987770,0.000096,0.077224,0.077320
10,14,24,54616,1704891,1759507,0.004578,0.065951,0.070529
9,14,23,6564,675036,681600,0.000621,0.024589,0.025210
10,13,23,11392,12256,23648,0.001030,0.000651,0.001681
9,14,23,16221,13173,29394,0.001311,0.000995,0.002306
10,13,23,29423,74086,103509,0.002589,0.003925,0.006514
10,14,24,24479,99962,124441,0.001869,0.004950,0.006819
9,13,22,5216,111399,116615,0.000436,0.005340,0.005776
10,14,24,8607,329810,338417,0.000765,0.014238,0.015003
9,13,22,8469,19703,28172,0.000730,0.001198,0.001928
10,16,26,39792,3553006,3592798,0.003140,0.138145,0.141285
10,12,22,72277,36065,108342,0.005500,0.001948,0.007448
9,16,25,7262,4587825,4595087,0.000603,0.174099,0.174702
10,14,24,30851,184609,215460,0.002456,0.008044,0.010500
10,14,24,43187,1864970,1908157,0.003384,0.060874,0.064258
10,12,22,11907,2449,14356,0.000981,0.000206,0.001187
8,15,23,637,948585,949222,0.000069,0.040634,0.040703
9,14,23,2041,977218,979259,0.000208,0.034767,0.034975
10,13,23,17102,147379,164481,0.001384,0.005639,0.007023
10,15,25,24137,896689,920826,0.001726,0.032767,0.034493
9,12,21,3091,105027,108118,0.000329,0.004151,0.004480
10,15,25,8960,796243,805203,0.000711,0.028984,0.029695
10,14,24,44542,355402,399944,0.002656,0.014486,0.017142
9,15,24,12979,466410,479389,0.001044,0.018201,0.019245
11,14,25,92860,1301422,1394282,0.006003,0.043787,0.049790
9,13,22,828,213800,214628,0.000123,0.008668,0.008791
10,14,24,16097,107969,124066,0.001382,0.005633,0.007015
8,14,22,1756,1805692,1807448,0.000172,0.062340,0.062512
10,13,23,39927,279837,319764,0.003052,0.010656,0.013708
8,16,24,248,2308890,2309138,0.000023,0.088272,0.088295
10,15,25,42105,689288,731393,0.003399,0.028578,0.031977
10,15,25,20815,571145,591960,0.001723,0.021689,0.023412
9,14,23,3388,296091,299479,0.000331,0.012014,0.012345
9,14,23,3913,328832,332745,0.000393,0.013844,0.014237
10,15,25,13103,3437408,3450511,0.001079,0.126464,0.127543
10,14,24,14807,197330,212137,0.001343,0.008165,0.009508
9,16,25,9525,1877298,1886823,0.000862,0.077203,0.078065
9,15,24,9667,1086174,1095841,0.000929,0.042283,0.043212
7,15,22,206,682210,682416,0.000020,0.031810,0.031830
9,15,24,2604,516742,519346,0.000301,0.023524,0.023825
9,15,24,1587,1848936,1850523,0.000188,0.073200,0.073388
10,15,25,15304,1953322,1968626,0.001314,0.077121,0.078435
10,14,24,16910,392574,409484,0.001547,0.015984,0.017531
10,15,25,10163,1524947,1535110,0.000834,0.054946,0.055780
10,15,25,47360,1019046,1066406,0.003639,0.041280,0.044919
10,15,25,33571,10981683,11015254,0.002786,0.345741,0.348527
10,15,25,19162,213554,232716,0.001706,0.009345,0.011051
10,15,25,16306,1242725,1259031,0.001290,0.051966,0.053256
9,14,23,6125,100096,106221,0.000634,0.004304,0.004938
10,16,26,21677,3925590,3947267,0.001924,0.152334,0.154258
10,14,24,18269,223549,241818,0.001485,0.009627,0.011112
9,13,22,22471,1085,23556,0.001741,0.000095,0.001836
11,13,24,72600,5174,77774,0.005610,0.000281,0.005891
10,14,24,30123,652942,683065,0.002321,0.026037,0.028358
9,15,24,18495,134803,153298,0.001494,0.005994,0.007488
8,11,19,1524,9193,10717,0.000138,0.000423,0.000561
10,14,24,25737,168500,194237,0.002132,0.007150,0.009282
9,14,23,853,7533795,7534648,0.000099,0.270725,0.270824
9,15,24,10118,2796634,2806752,0.000912,0.103110,0.104022
8,14,22,545,223262,223807,0.000059,0.010337,0.010396
10,10,20,12990,966,13956,0.001139,0.000061,0.001200
10,13,23,20019,158400,178419,0.001529,0.006695,0.008224
10,15,25,37194,4778112,4815306,0.003186,0.177913,0.181099
10,14,24,16428,64976,81404,0.001482,0.003006,0.004488
10,15,25,20077,939665,959742,0.001671,0.043166,0.044837
9,14,23,5750,275675,281425,0.000571,0.014108,0.014679
10,14,24,25060,80962,106022,0.002112,0.004063,0.006175
10,16,26,16087,3393033,3409120,0.001357,0.129443,0.130800
9,14,23,12884,90784,103668,0.001118,0.004443,0.005561
11,13,24,79508,315210,394718,0.006219,0.014088,0.020307
8,14,22,398,199577,199975,0.000043,0.008902,0.008945
10,14,24,44896,880706,925602,0.003917,0.032922,0.036839
10,13,23,47671,193933,241604,0.003941,0.008210,0.012151
9,13,22,4411,384664,389075,0.000399,0.015352,0.015751
10,12,22,25887,79389,105276,0.002064,0.003517,0.005581
9,15,24,808,2610282,2611090,0.000088,0.096198,0.096286
9,13,22,10279,19788,30067,0.001028,0.000839,0.001867
9,15,24,1851,1140827,1142678,0.000178,0.042382,0.042560
10,14,24,61703,655779,717482,0.004800,0.026433,0.031233
10,13,23,15142,224989,240131,0.001310,0.009218,0.010528
10,15,25,45164,6128754,6173918,0.003593,0.229281,0.232874
10,15,25,15957,1698047,1714004,0.001419,0.065265,0.066684
9,12,21,889,26288,27177,0.000121,0.001280,0.001401
9,15,24,18460,429654,448114,0.001461,0.019983,0.021444
10,12,22,55255,3231,58486,0.004487,0.000179,0.004666
10,14,24,3961,281967,285928,0.000356,0.012139,0.012495
10,12,22,19060,782,19842,0.001591,0.000066,0.001657
9,15,24,2397,328934,331331,0.000234,0.014607,0.014841
9,14,23,6112,488856,494968,0.000578,0.018602,0.019180
9,13,22,20070,22881,42951,0.001553,0.001241,0.002794
10,16,26,14976,5530864,5545840,0.001260,0.217379,0.218639
11,15,26,94190,895792,989982,0.007547,0.034899,0.042446
10,15,25,20300,782039,802339,0.001762,0.031382,0.033144
8,15,23,1400,609968,611368,0.000168,0.028347,0.028515
9,14,23,9870,470588,480458,0.000905,0.019421,0.020326
10,13,23,13428,51263,64691,0.001237,0.002548,0.003785
10,16,26,18885,1822931,1841816,0.001662,0.074506,0.076168
9,14,23,1153,1180580,1181733,0.000152,0.043616,0.043768
9,13,22,6572,96580,103152,0.000640,0.004829,0.005469
10,13,23,28829,167979,196808,0.002593,0.007368,0.009961
10,12,22,24771,31533,56304,0.002077,0.001673,0.003750
9,15,24,3421,1200810,1204231,0.000283,0.046630,0.046913
9,14,23,973,206400,207373,0.000136,0.009201,0.009337
10,14,24,7884,2779555,2787439,0.000720,0.096205,0.096925
9,15,24,10780,589390,600170,0.000979,0.024874,0.025853
9,14,23,10662,441057,451719,0.000786,0.018511,0.019297
10,14,24,5189,969815,975004,0.000545,0.040374,0.040919
9,15,24,879,378932,379811,0.000099,0.018983,0.019082
9,15,24,8300,7999000,8007300,0.000621,0.285669,0.286290
9,13,22,2002,89887,91889,0.000240,0.004130,0.004370
9,12,21,6958,42787,49745,0.000586,0.001775,0.002361
10,14,24,22803,726658,749461,0.002089,0.028169,0.030258
10,13,23,44126,581695,625821,0.003786,0.021118,0.024904
9,14,23,4431,654096,658527,0.000451,0.025584,0.026035
10,15,25,13783,3340995,3354778,0.001326,0.120730,0.122056
10,13,23,17800,14252,32052,0.001664,0.000889,0.002553
10,14,24,37062,121568,158630,0.002992,0.005258,0.008250
9,15,24,685,649626,650311,0.000083,0.026505,0.026588
9,12,21,12409,38816,51225,0.001102,0.001701,0.002803
10,15,25,24506,636738,661244,0.002031,0.028084,0.030115
10,12,22,7957,93531,101488,0.000794,0.004386,0.005180
10,13,23,43111,267347,310458,0.003476,0.010774,0.014250
10,14,24,21775,504019,525794,0.001794,0.019463,0.021257
10,13,23,24459,6885,31344,0.001976,0.000315,0.002291
10,14,24,34120,611526,645646,0.002805,0.025819,0.028624
9,12,21,2064,2549,4613,0.000234,0.000221,0.000455
9,15,24,2446,5341513,5343959,0.000238,0.179751,0.179989
10,15,25,33036,1430644,1463680,0.002869,0.054461,0.057330
10,14,24,14836,744821,759657,0.001407,0.028172,0.029579
9,14,23,6807,596855,603662,0.000657,0.022124,0.022781
9,14,23,1207,254288,255495,0.000153,0.011221,0.011374
10,14,24,37752,14570,52322,0.003287,0.001262,0.004549
9,14,23,12151,215694,227845,0.001063,0.010239,0.011302
9,15,24,9803,239146,248949,0.000885,0.012868,0.013753
10,13,23,6598,431750,438348,0.000653,0.018280,0.018933
10,15,25,36228,1685923,1722151,0.002658,0.070177,0.072835
9,14,23,2433,4506055,4508488,0.000266,0.139942,0.140208
10,14,24,17059,504729,521788,0.001501,0.020719,0.022220
11,14,25,97700,503967,601667,0.007290,0.020131,0.027421
9,14,23,2536,335001,337537,0.000287,0.013992,0.014279
9,15,24,7876,2580054,2587930,0.000727,0.090583,0.091310
9,11,20,8428,6816,15244,0.000761,0.000404,0.001165
9,14,23,7933,1355197,1363130,0.000702,0.047615,0.048317
9,12,21,12548,10051,22599,0.001095,0.000538,0.001633
10,14,24,20095,664052,684147,0.001688,0.027399,0.029087
10,13,23,8451,154043,162494,0.000821,0.006020,0.006841
8,14,22,487,1525078,1525565,0.000041,0.054968,0.055009
10,14,24,21560,339771,361331,0.001904,0.014275,0.016179
9,13,22,6877,106158,113035,0.000615,0.004650,0.005265
10,15,25,48601,5066226,5114827,0.003774,0.179948,0.183722
9,13,22,10866,62337,73203,0.000981,0.002694,0.003675
9,14,23,4226,604343,608569,0.000375,0.025392,0.025767
8,14,22,1593,336538,338131,0.000150,0.014242,0.014392
10,13,23,11328,325354,336682,0.001058,0.011795,0.012853
11,13,24,129307,163954,293261,0.010045,0.007236,0.017281
10,15,25,11874,363657,375531,0.001029,0.018739,0.019768
10,15,25,8114,2966764,2974878,0.000749,0.109228,0.109977
10,14,24,14392,886816,901208,0.001383,0.031687,0.033070
9,13,22,9895,145310,155205,0.000868,0.006046,0.006914
9,15,24,1714,1595012,1596726,0.000194,0.074293,0.074487
10,13,23,36137,96343,132480,0.003286,0.005337,0.008623
10,14,24,13526,423519,437045,0.001144,0.018417,0.019561
9,13,22,4064,119814,123878,0.000428,0.005260,0.005688
10,15,25,35190,766932,802122,0.002966,0.029944,0.032910
9,14,23,2863,1007446,1010309,0.000302,0.037614,0.037916
9,15,24,18243,3124866,3143109,0.001664,0.113122,0.114786
10,14,24,52798,325316,378114,0.004580,0.013786,0.018366
9,14,23,5321,283611,288932,0.000527,0.013043,0.013570
10,13,23,51134,114222,165356,0.004074,0.005589,0.009663
10,14,24,20965,2147274,2168239,0.001677,0.076956,0.078633
9,13,22,3757,1920,5677,0.000495,0.000193,0.000688
10,15,25,44310,327695,372005,0.002782,0.015562,0.018344
9,16,25,2196,3083206,3085402,0.000220,0.120679,0.120899
9,13,22,1256,515618,516874,0.000167,0.019753,0.019920
8,15,23,837,980319,981156,0.000115,0.040329,0.040444
8,13,21,784,3238,4022,0.000108,0.000256,0.000364
9,14,23,2336,334937,337273,0.000257,0.012267,0.012524
9,13,22,4589,146530,151119,0.000442,0.006843,0.007285
10,14,24,15543,647540,663083,0.001402,0.025915,0.027317
8,14,22,1505,129877,131382,0.000174,0.007392,0.007566
9,15,24,6383,352370,358753,0.000579,0.017151,0.017730
9,14,23,2743,1162224,1164967,0.000289,0.044814,0.045103
9,13,22,9545,307957,317502,0.000931,0.012453,0.013384
10,15,25,38490,1602589,1641079,0.003345,0.063273,0.066618
10,12,22,23259,16716,39975,0.002139,0.000806,0.002945
10,15,25,57456,240787,298243,0.004484,0.011150,0.015634
10,9,19,31093,1197,32290,0.002480,0.000082,0.002562
10,13,23,51795,27326,79121,0.004175,0.002166,0.006341
7,15,22,158,532692,532850,0.000008,0.025832,0.025840
10,13,23,131111,442948,574059,0.009553,0.016887,0.026440
10,13,23,36626,11631,48257,0.002625,0.000672,0.003297
10,12,22,18770,24585,43355,0.001367,0.001350,0.002717
10,13,23,84151,314741,398892,0.005863,0.012110,0.017973
10,15,25,33337,372002,405339,0.002404,0.016542,0.018946
10,13,23,16658,647917,664575,0.001288,0.023553,0.024841
10,15,25,11114,1076914,1088028,0.000882,0.041113,0.041995
9,14,23,6904,103633,110537,0.000613,0.004388,0.005001
10,13,23,14481,58415,72896,0.001119,0.002404,0.003523
9,14,23,4421,12938,17359,0.000356,0.000938,0.001294
9,12,21,11974,240913,252887,0.000894,0.008456,0.009350
8,15,23,273,4700880,4701153,0.000026,0.178564,0.178590
9,13,22,9602,56468,66070,0.000916,0.002463,0.003379
10,13,23,28577,32376,60953,0.002295,0.001482,0.003777
10,13,23,20783,149775,170558,0.001639,0.006050,0.007689
10,13,23,43523,131055,174578,0.003095,0.005460,0.008555
11,14,25,103078,117650,220728,0.007187,0.004886,0.012073
10,14,24,26884,331322,358206,0.001885,0.013855,0.015740
9,15,24,5949,1994774,2000723,0.000535,0.071824,0.072359
10,14,24,17446,387989,405435,0.001604,0.015240,0.016844
10,13,23,41884,81268,123152,0.003601,0.004424,0.008025
9,12,21,3567,25414,28981,0.000312,0.001439,0.001751
10,13,23,35181,26425,61606,0.002917,0.001580,0.004497
10,13,23,16232,160763,176995,0.001286,0.007313,0.008599
10,13,23,19400,32475,51875,0.001554,0.001765,0.003319
10,13,23,17612,101738,119350,0.001506,0.005383,0.006889
9,13,22,3801,132796,136597,0.000296,0.004934,0.005230
10,15,25,11407,3298481,3309888,0.000920,0.124512,0.125432
10,13,23,8895,5128,14023,0.000894,0.000374,0.001268
10,14,24,19060,418800,437860,0.001562,0.017884,0.019446
9,14,23,10408,915197,925605,0.000923,0.034923,0.035846
8,14,22,740,47599,48339,0.000096,0.002242,0.002338
10,12,22,40631,1340,41971,0.003444,0.000093,0.003537
9,15,24,4300,1430881,1435181,0.000420,0.057569,0.057989
10,12,22,35694,108436,144130,0.002910,0.004134,0.007044
10,13,23,85278,301,85579,0.006795,0.000027,0.006822
10,13,23,30806,28878,59684,0.002045,0.001468,0.003513
10,16,26,10637,8416853,8427490,0.000797,0.331861,0.332658
9,13,22,5251,10606,15857,0.000518,0.000680,0.001198
10,14,24,54052,1092077,1146129,0.004238,0.040011,0.044249
10,15,25,12037,2665163,2677200,0.001273,0.108757,0.110030
10,15,25,15551,713830,729381,0.001471,0.029111,0.030582
8,13,21,2614,382205,384819,0.000236,0.015355,0.015591
10,13,23,36468,95409,131877,0.003237,0.005134,0.008371
9,14,23,5646,1409526,1415172,0.000508,0.053114,0.053622
11,14,25,156858,864538,1021396,0.011351,0.032830,0.044181
10,15,25,39141,1310277,1349418,0.003253,0.056455,0.059708
10,14,24,134416,165794,300210,0.009255,0.006911,0.016166
10,15,25,15790,2214764,2230554,0.001234,0.080252,0.081486
10,12,22,12829,140527,153356,0.001204,0.005213,0.006417
9,12,21,3891,12354,16245,0.000344,0.000670,0.001014
10,14,24,43067,174657,217724,0.003209,0.008615,0.011824
9,13,22,8488,31395,39883,0.000776,0.001619,0.002395
11,14,25,121343,3851465,3972808,0.008513,0.126203,0.134716
10,15,25,38697,1494874,1533571,0.003007,0.055438,0.058445
10,13,23,14850,110559,125409,0.001396,0.004387,0.005783
9,16,25,7062,3610650,3617712,0.000629,0.143551,0.144180
10,13,23,22937,18198,41135,0.002003,0.001012,0.003015
9,13,22,18585,286360,304945,0.001526,0.012588,0.014114
10,15,25,44241,511522,555763,0.003612,0.024078,0.027690
9,11,20,10883,11307,22190,0.000897,0.000548,0.001445
10,15,25,61296,337645,398941,0.004510,0.014887,0.019397
8,13,21,3768,74098,77866,0.000355,0.002795,0.003150
9,15,24,2637,213582,216219,0.000242,0.009663,0.009905
9,15,24,14992,2379775,2394767,0.001181,0.091384,0.092565
10,12,22,13229,7242,20471,0.001231,0.000424,0.001655
