phase1_solution_length,phase2_solution_length,solution_length,phase1_move_count,phase2_move_count,move_count,phase1_solve_time,phase2_solve_time,solve_time
9,16,25,1800,5383076,5384876,0.000196,0.197886,0.198082
9,14,23,2212,190310,192522,0.000197,0.007165,0.007362
8,15,23,496,2563669,2564165,0.000045,0.092726,0.092771
10,14,24,10144,420988,431132,0.000780,0.014572,0.015352
9,16,25,7188,7585647,7592835,0.000565,0.264604,0.265169
9,15,24,6123,433510,439633,0.000507,0.015316,0.015823
9,14,23,3364,599143,602507,0.000296,0.020244,0.020540
9,15,24,8745,1674082,1682827,0.000685,0.055465,0.056150
10,13,23,17975,23967,41942,0.001276,0.001157,0.002433
10,13,23,35758,46397,82155,0.002257,0.001993,0.004250
10,14,24,51175,4738818,4789993,0.003087,0.163484,0.166571
9,14,23,4705,245095,249800,0.000380,0.008755,0.009135
10,14,24,29344,209830,239174,0.001994,0.007956,0.009950
8,15,23,888,3341016,3341904,0.000074,0.114823,0.114897
10,14,24,77427,254859,332286,0.004873,0.008981,0.013854
9,13,22,7480,25795,33275,0.000549,0.001276,0.001825
10,15,25,53471,672636,726107,0.003627,0.025284,0.028911
10,14,24,14470,1177494,1191964,0.001026,0.037873,0.038899
10,15,25,63587,430106,493693,0.004025,0.016364,0.020389
9,12,21,10404,21684,32088,0.000795,0.000921,0.001716
9,12,21,4306,41241,45547,0.000331,0.001752,0.002083
10,16,26,77063,3845086,3922149,0.005102,0.143878,0.148980
9,11,20,9396,26421,35817,0.000718,0.000995,0.001713
8,15,23,796,1157460,1158256,0.000060,0.040652,0.040712
10,14,24,9916,269044,278960,0.000786,0.010085,0.010871
9,15,24,7886,4739466,4747352,0.000624,0.163216,0.163840
9,15,24,741,1080527,1081268,0.000075,0.040674,0.040749
9,15,24,8176,1113412,1121588,0.000652,0.040044,0.040696
8,14,22,1658,599254,600912,0.000161,0.026195,0.026356
8,13,21,1731,434967,436698,0.000157,0.016008,0.016165
10,15,25,16227,364854,381081,0.001308,0.012804,0.014112
8,13,21,3342,114765,118107,0.000267,0.004722,0.004989
9,13,22,10628,75706,86334,0.000782,0.002920,0.003702
10,15,25,35162,1871288,1906450,0.002569,0.065228,0.067797
9,13,22,6410,78411,84821,0.000535,0.002969,0.003504
10,14,24,45919,1414920,1460839,0.003213,0.048730,0.051943
10,16,26,5056,2875155,2880211,0.000410,0.104005,0.104415
8,13,21,392,62428,62820,0.000040,0.002662,0.002702
10,16,26,12003,3098826,3110829,0.000925,0.119654,0.120579
10,13,23,16254,695,16949,0.001223,0.000066,0.001289
9,16,25,10752,1745904,1756656,0.000725,0.066503,0.067228
9,13,22,2628,197483,200111,0.000205,0.007050,0.007255
10,15,25,8452,2663319,2671771,0.000653,0.092670,0.093323
9,15,24,1981,1297368,1299349,0.000182,0.045926,0.046108
10,12,22,23487,16758,40245,0.001719,0.000710,0.002429
10,14,24,31816,493535,525351,0.002140,0.017883,0.020023
10,14,24,15546,864630,880176,0.001229,0.029855,0.031084
9,15,24,16244,3463433,3479677,0.001163,0.129047,0.130210
10,15,25,9162,415483,424645,0.000720,0.014974,0.015694
9,14,23,7885,213738,221623,0.000615,0.008464,0.009079
9,14,23,3842,1311969,1315811,0.000318,0.043474,0.043792
8,14,22,1136,1904046,1905182,0.000097,0.070417,0.070514
9,15,24,5202,761543,766745,0.000456,0.033534,0.033990
9,12,21,8319,68096,76415,0.000721,0.002986,0.003707
9,14,23,2260,170438,172698,0.000206,0.008297,0.008503
10,14,24,7993,699660,707653,0.000702,0.030818,0.031520
10,14,24,7862,516781,524643,0.000674,0.023895,0.024569
9,15,24,1660,3007888,3009548,0.000160,0.114909,0.115069
9,14,23,29222,352836,382058,0.001925,0.014195,0.016120
9,14,23,7050,167783,174833,0.000550,0.006824,0.007374
10,13,23,12653,214262,226915,0.000962,0.008125,0.009087
9,14,23,3396,221348,224744,0.000242,0.008455,0.008697
10,13,23,24232,4738,28970,0.001803,0.000257,0.002060
8,15,23,689,251287,251976,0.000053,0.009472,0.009525
10,16,26,73608,1402345,1475953,0.004800,0.055549,0.060349
10,15,25,23365,1547221,1570586,0.001783,0.051323,0.053106
10,14,24,13045,248189,261234,0.001012,0.009860,0.010872
10,15,25,6856,2293550,2300406,0.000573,0.082402,0.082975
9,14,23,2390,4065203,4067593,0.000206,0.132546,0.132752
9,14,23,6678,1236153,1242831,0.000516,0.040867,0.041383
10,14,24,15626,620300,635926,0.001207,0.020235,0.021442
9,13,22,6098,216276,222374,0.000482,0.007948,0.008430
10,13,23,23228,14789,38017,0.001793,0.001018,0.002811
8,14,22,4321,169438,173759,0.000316,0.006392,0.006708
10,15,25,45605,5627540,5673145,0.002984,0.198294,0.201278
9,15,24,6864,151700,158564,0.000594,0.006143,0.006737
10,14,24,49831,53697,103528,0.003232,0.002881,0.006113
10,13,23,13345,13507,26852,0.000941,0.000715,0.001656
9,15,24,5591,2415061,2420652,0.000423,0.102315,0.102738
9,14,23,9137,1322872,1332009,0.000693,0.050287,0.050980
10,15,25,20889,332221,353110,0.001513,0.013783,0.015296
10,15,25,14133,2260245,2274378,0.001195,0.087819,0.089014
10,13,23,7977,239703,247680,0.000638,0.010399,0.011037
9,14,23,9824,195949,205773,0.000748,0.008413,0.009161
10,13,23,52408,87247,139655,0.003865,0.004530,0.008395
10,14,24,41909,1657120,1699029,0.003038,0.056328,0.059366
9,13,22,8663,25291,33954,0.000653,0.001114,0.001767
9,14,23,2518,567940,570458,0.000192,0.020944,0.021136
10,13,23,107126,239713,346839,0.006624,0.009235,0.015859
9,15,24,1000,271844,272844,0.000084,0.011422,0.011506
10,14,24,36396,2230143,2266539,0.002677,0.082510,0.085187
10,15,25,23777,601056,624833,0.001617,0.027325,0.028942
10,15,25,13601,1951094,1964695,0.001067,0.070155,0.071222
11,14,25,97419,227878,325297,0.006305,0.009212,0.015517
10,15,25,7132,257094,264226,0.000619,0.013067,0.013686
9,15,24,3090,514313,517403,0.000287,0.025884,0.026171
10,14,24,17680,170036,187716,0.001523,0.007341,0.008864
8,14,22,629,1063829,1064458,0.000064,0.041282,0.041346
10,14,24,9265,3618553,3627818,0.000748,0.125662,0.126410
8,14,22,1125,1263457,1264582,0.000096,0.041762,0.041858
10,13,23,23113,157948,181061,0.001767,0.006287,0.008054
10,13,23,11809,69396,81205,0.001004,0.003649,0.004653
10,15,25,17634,5522833,5540467,0.001304,0.192018,0.193322
10,15,25,26019,1055614,1081633,0.002044,0.043610,0.045654
10,15,25,18750,680632,699382,0.001388,0.026448,0.027836
10,14,24,64000,104801,168801,0.004792,0.005646,0.010438
9,14,23,3036,92504,95540,0.000270,0.005404,0.005674
9,13,22,1446,76774,78220,0.000151,0.004207,0.004358
10,14,24,41894,72063,113957,0.002642,0.003782,0.006424
9,14,23,4295,772660,776955,0.000371,0.030534,0.030905
8,15,23,2842,173314,176156,0.000294,0.007991,0.008285
10,14,24,44884,624687,669571,0.003280,0.025140,0.028420
10,13,23,34161,119444,153605,0.002505,0.004967,0.007472
10,14,24,15468,783131,798599,0.001150,0.031165,0.032315
10,14,24,30605,73720,104325,0.002051,0.003213,0.005264
10,14,24,35503,146183,181686,0.002408,0.006091,0.008499
10,15,25,13075,811800,824875,0.000951,0.030012,0.030963
9,12,21,15357,39744,55101,0.001229,0.001889,0.003118
9,14,23,2197,418886,421083,0.000223,0.017288,0.017511
10,14,24,22562,693807,716369,0.001852,0.025981,0.027833
9,13,22,9896,41314,51210,0.000864,0.001866,0.002730
9,15,24,2103,1619097,1621200,0.000193,0.055800,0.055993
10,14,24,6964,12776,19740,0.000650,0.000909,0.001559
10,14,24,14285,1448620,1462905,0.001100,0.055081,0.056181
10,15,25,20023,1878002,1898025,0.001569,0.073158,0.074727
9,14,23,1694,171326,173020,0.000165,0.006618,0.006783
10,15,25,12190,423442,435632,0.000925,0.016519,0.017444
10,15,25,70911,987449,1058360,0.004366,0.040263,0.044629
10,12,22,31671,12890,44561,0.002646,0.000890,0.003536
7,14,21,577,214380,214957,0.000042,0.008603,0.008645
9,14,23,7161,1941795,1948956,0.000574,0.069023,0.069597
10,15,25,37225,802453,839678,0.002688,0.030121,0.032809
10,15,25,77768,1059454,1137222,0.004899,0.043924,0.048823
10,14,24,16747,559584,576331,0.001374,0.024790,0.026164
10,14,24,26505,101743,128248,0.002068,0.004136,0.006204
9,11,20,3695,4701,8396,0.000343,0.000294,0.000637
9,14,23,1863,9551220,9553083,0.000163,0.343642,0.343805
10,11,21,20659,1671,22330,0.001292,0.000114,0.001406
10,15,25,35782,461245,497027,0.002661,0.018339,0.021000
9,14,23,4098,139017,143115,0.000389,0.005982,0.006371
8,14,22,2599,1349393,1351992,0.000223,0.045120,0.045343
10,15,25,18386,900145,918531,0.001446,0.033753,0.035199
9,12,21,3441,14835,18276,0.000331,0.000754,0.001085
10,13,23,89310,20755,110065,0.005643,0.000967,0.006610
11,15,26,91145,4216145,4307290,0.005312,0.152865,0.158177
10,14,24,7447,135322,142769,0.000647,0.005484,0.006131
9,15,24,1138,1986632,1987770,0.000108,0.075589,0.075697
10,14,24,54616,1704891,1759507,0.003779,0.062989,0.066768
9,14,23,6564,675036,681600,0.000572,0.027518,0.028090
10,13,23,11392,12256,23648,0.000874,0.000659,0.001533
9,14,23,16221,13173,29394,0.001148,0.001006,0.002154
10,13,23,29423,74086,103509,0.002190,0.003921,0.006111
10,14,24,24479,99962,124441,0.001842,0.004739,0.006581
9,13,22,5216,111399,116615,0.000414,0.004474,0.004888
10,14,24,8607,329810,338417,0.000755,0.013105,0.013860
9,13,22,8469,19703,28172,0.000666,0.001063,0.001729
10,16,26,39792,3553006,3592798,0.002804,0.135693,0.138497
10,12,22,72277,36065,108342,0.004459,0.001810,0.006269
9,16,25,7262,4587825,4595087,0.000536,0.160437,0.160973
10,14,24,30851,184609,215460,0.002201,0.007261,0.009462
10,14,24,43187,1864970,1908157,0.003170,0.059790,0.062960
10,12,22,11907,2449,14356,0.001005,0.000201,0.001206
8,15,23,637,948585,949222,0.000067,0.040275,0.040342
9,14,23,2041,977218,979259,0.000211,0.034460,0.034671
10,13,23,17102,147379,164481,0.001409,0.005557,0.006966
10,15,25,24137,896689,920826,0.001711,0.036855,0.038566
9,12,21,3091,105027,108118,0.000350,0.005201,0.005551
10,15,25,8960,796243,805203,0.000734,0.029625,0.030359
10,14,24,44542,355402,399944,0.002591,0.014297,0.016888
9,15,24,12979,466410,479389,0.001010,0.018057,0.019067
11,14,25,92860,1301422,1394282,0.006148,0.043762,0.049910
9,13,22,828,213800,214628,0.000113,0.008440,0.008553
10,14,24,16097,107969,124066,0.001236,0.005723,0.006959
8,14,22,1756,1805692,1807448,0.000165,0.062393,0.062558
10,13,23,39927,279837,319764,0.002981,0.010525,0.013506
8,16,24,248,2308890,2309138,0.000023,0.088239,0.088262
10,15,25,42105,689288,731393,0.003034,0.027877,0.030911
10,15,25,20815,571145,591960,0.001638,0.021773,0.023411
9,14,23,3388,296091,299479,0.000329,0.011297,0.011626
9,14,23,3913,328832,332745,0.000383,0.012882,0.013265
10,15,25,13103,3437408,3450511,0.001023,0.125040,0.126063
10,14,24,14807,197330,212137,0.001201,0.007516,0.008717
9,16,25,9525,1877298,1886823,0.000725,0.073898,0.074623
9,15,24,9667,1086174,1095841,0.000816,0.040946,0.041762
7,15,22,206,682210,682416,0.000020,0.036210,0.036230
9,15,24,2604,516742,519346,0.000251,0.027517,0.027768
9,15,24,1587,1848936,1850523,0.000166,0.066648,0.066814
10,15,25,15304,1953322,1968626,0.001208,0.070700,0.071908
10,14,24,16910,392574,409484,0.001408,0.015058,0.016466
10,15,25,10163,1524947,1535110,0.000825,0.053897,0.054722
10,15,25,47360,1019046,1066406,0.003452,0.039958,0.043410
10,15,25,33571,10981683,11015254,0.002514,0.372125,0.374639
10,15,25,19162,213554,232716,0.001600,0.009251,0.010851
10,15,25,16306,1242725,1259031,0.001255,0.054159,0.055414
9,14,23,6125,100096,106221,0.000595,0.004193,0.004788
10,16,26,21677,3925590,3947267,0.001767,0.149254,0.151021
10,14,24,18269,223549,241818,0.001306,0.008923,0.010229
9,13,22,22471,1085,23556,0.001539,0.000101,0.001640
11,13,24,72600,5174,77774,0.004584,0.000285,0.004869
10,14,24,30123,652942,683065,0.001994,0.023604,0.025598
9,15,24,18495,134803,153298,0.001262,0.005625,0.006887
8,11,19,1524,9193,10717,0.000127,0.000422,0.000549
10,14,24,25737,168500,194237,0.001830,0.006539,0.008369
9,14,23,853,7533795,7534648,0.000099,0.259872,0.259971
9,15,24,10118,2796634,2806752,0.000832,0.115286,0.116118
8,14,22,545,223262,223807,0.000083,0.013291,0.013374
10,10,20,12990,966,13956,0.001005,0.000067,0.001072
10,13,23,20019,158400,178419,0.001392,0.006681,0.008073
10,15,25,37194,4778112,4815306,0.003146,0.177292,0.180438
10,14,24,16428,64976,81404,0.001337,0.002804,0.004141
10,15,25,20077,939665,959742,0.001492,0.040299,0.041791
9,14,23,5750,275675,281425,0.000523,0.012647,0.013170
10,14,24,25060,80962,106022,0.001778,0.003789,0.005567
10,16,26,16087,3393033,3409120,0.001187,0.139630,0.140817
9,14,23,12884,90784,103668,0.000994,0.004095,0.005089
11,13,24,79508,315210,394718,0.005304,0.012605,0.017909
8,14,22,398,199577,199975,0.000055,0.007967,0.008022
10,14,24,44896,880706,925602,0.003280,0.031012,0.034292
10,13,23,47671,193933,241604,0.003421,0.008435,0.011856
9,13,22,4411,384664,389075,0.000394,0.014776,0.015170
10,12,22,25887,79389,105276,0.001786,0.003250,0.005036
9,15,24,808,2610282,2611090,0.000091,0.104540,0.104631
9,13,22,10279,19788,30067,0.000897,0.000873,0.001770
9,15,24,1851,1140827,1142678,0.000165,0.045404,0.045569
10,14,24,61703,655779,717482,0.004028,0.024833,0.028861
10,13,23,15142,224989,240131,0.001142,0.008517,0.009659
10,15,25,45164,6128754,6173918,0.003148,0.211723,0.214871
10,15,25,15957,1698047,1714004,0.001216,0.063001,0.064217
9,12,21,889,26288,27177,0.000126,0.001119,0.001245
9,15,24,18460,429654,448114,0.001298,0.017827,0.019125
10,12,22,55255,3231,58486,0.003766,0.000192,0.003958
10,14,24,3961,281967,285928,0.000322,0.013438,0.013760
10,12,22,19060,782,19842,0.001439,0.000068,0.001507
9,15,24,2397,328934,331331,0.000217,0.015132,0.015349
9,14,23,6112,488856,494968,0.000513,0.017961,0.018474
9,13,22,20070,22881,42951,0.001389,0.001214,0.002603
10,16,26,14976,5530864,5545840,0.001087,0.210030,0.211117
11,15,26,94190,895792,989982,0.006054,0.033770,0.039824
10,15,25,20300,782039,802339,0.001535,0.029004,0.030539
8,15,23,1400,609968,611368,0.000159,0.025610,0.025769
9,14,23,9870,470588,480458,0.000787,0.017650,0.018437
10,13,23,13428,51263,64691,0.001087,0.002403,0.003490
10,16,26,18885,1822931,1841816,0.001414,0.070714,0.072128
9,14,23,1153,1180580,1181733,0.000145,0.044467,0.044612
9,13,22,6572,96580,103152,0.000573,0.004594,0.005167
10,13,23,28829,167979,196808,0.002350,0.007550,0.009900
10,12,22,24771,31533,56304,0.001914,0.001598,0.003512
9,15,24,3421,1200810,1204231,0.000249,0.048520,0.048769
9,14,23,973,206400,207373,0.000100,0.009648,0.009748
10,14,24,7884,2779555,2787439,0.000643,0.114207,0.114850
9,15,24,10780,589390,600170,0.000853,0.026966,0.027819
9,14,23,10662,441057,451719,0.000714,0.019888,0.020602
10,14,24,5189,969815,975004,0.000450,0.041085,0.041535
9,15,24,879,378932,379811,0.000092,0.016817,0.016909
9,15,24,8300,7999000,8007300,0.000572,0.342227,0.342799
9,13,22,2002,89887,91889,0.000232,0.004256,0.004488
9,12,21,6958,42787,49745,0.000539,0.001811,0.002350
10,14,24,22803,726658,749461,0.001736,0.030196,0.031932
10,13,23,44126,581695,625821,0.003191,0.022122,0.025313
9,14,23,4431,654096,658527,0.000420,0.029344,0.029764
10,15,25,13783,3340995,3354778,0.001197,0.151460,0.152657
10,13,23,17800,14252,32052,0.001532,0.001019,0.002551
10,14,24,37062,121568,158630,0.002747,0.005384,0.008131
9,15,24,685,649626,650311,0.000081,0.028407,0.028488
9,12,21,12409,38816,51225,0.000947,0.001745,0.002692
10,15,25,24506,636738,661244,0.001864,0.027978,0.029842
10,12,22,7957,93531,101488,0.000688,0.004074,0.004762
10,13,23,43111,267347,310458,0.003038,0.009792,0.012830
10,14,24,21775,504019,525794,0.001588,0.019092,0.020680
10,13,23,24459,6885,31344,0.001831,0.000336,0.002167
10,14,24,34120,611526,645646,0.002313,0.028113,0.030426
9,12,21,2064,2549,4613,0.000206,0.000211,0.000417
9,15,24,2446,5341513,5343959,0.000232,0.204677,0.204909
10,15,25,33036,1430644,1463680,0.002628,0.063257,0.065885
10,14,24,14836,744821,759657,0.001205,0.032306,0.033511
9,14,23,6807,596855,603662,0.000581,0.024024,0.024605
9,14,23,1207,254288,255495,0.000123,0.010975,0.011098
10,14,24,37752,14570,52322,0.002856,0.001452,0.004308
9,14,23,12151,215694,227845,0.000935,0.009661,0.010596
9,15,24,9803,239146,248949,0.000795,0.013144,0.013939
10,13,23,6598,431750,438348,0.000570,0.015274,0.015844
10,15,25,36228,1685923,1722151,0.002666,0.077263,0.079929
9,14,23,2433,4506055,4508488,0.000260,0.179421,0.179681
10,14,24,17059,504729,521788,0.001499,0.021978,0.023477
11,14,25,97700,503967,601667,0.007314,0.024365,0.031679
9,14,23,2536,335001,337537,0.000252,0.015496,0.015748
9,15,24,7876,2580054,2587930,0.000688,0.110955,0.111643
9,11,20,8428,6816,15244,0.000658,0.000387,0.001045
9,14,23,7933,1355197,1363130,0.000641,0.050761,0.051402
9,12,21,12548,10051,22599,0.000966,0.000539,0.001505
10,14,24,20095,664052,684147,0.001536,0.029523,0.031059
10,13,23,8451,154043,162494,0.000727,0.006181,0.006908
8,14,22,487,1525078,1525565,0.000055,0.068501,0.068556
10,14,24,21560,339771,361331,0.001596,0.015972,0.017568
9,13,22,6877,106158,113035,0.000550,0.004446,0.004996
10,15,25,48601,5066226,5114827,0.003518,0.205979,0.209497
9,13,22,10866,62337,73203,0.000860,0.002580,0.003440
9,14,23,4226,604343,608569,0.000365,0.027335,0.027700
8,14,22,1593,336538,338131,0.000137,0.014891,0.015028
10,13,23,11328,325354,336682,0.000989,0.012531,0.013520
11,13,24,129307,163954,293261,0.009224,0.007650,0.016874
10,15,25,11874,363657,375531,0.001081,0.020688,0.021769
10,15,25,8114,2966764,2974878,0.000714,0.131323,0.132037
10,14,24,14392,886816,901208,0.001266,0.037788,0.039054
9,13,22,9895,145310,155205,0.000716,0.006824,0.007540
9,15,24,1714,1595012,1596726,0.000166,0.071947,0.072113
10,13,23,36137,96343,132480,0.002660,0.004705,0.007365
10,14,24,13526,423519,437045,0.001096,0.017529,0.018625
9,13,22,4064,119814,123878,0.000380,0.005093,0.005473
10,15,25,35190,766932,802122,0.002630,0.029339,0.031969
9,14,23,2863,1007446,1010309,0.000276,0.037210,0.037486
9,15,24,18243,3124866,3143109,0.001390,0.112288,0.113678
10,14,24,52798,325316,378114,0.003890,0.012702,0.016592
9,14,23,5321,283611,288932,0.000493,0.011482,0.011975
10,13,23,51134,114222,165356,0.003468,0.005138,0.008606
10,14,24,20965,2147274,2168239,0.001515,0.075274,0.076789
9,13,22,3757,1920,5677,0.000367,0.000158,0.000525
10,15,25,44310,327695,372005,0.002373,0.013986,0.016359
9,16,25,2196,3083206,3085402,0.000211,0.115830,0.116041
9,13,22,1256,515618,516874,0.000158,0.018137,0.018295
8,15,23,837,980319,981156,0.000103,0.040597,0.040700
8,13,21,784,3238,4022,0.000099,0.000264,0.000363
9,14,23,2336,334937,337273,0.000255,0.011712,0.011967
9,13,22,4589,146530,151119,0.000410,0.006065,0.006475
10,14,24,15543,647540,663083,0.001262,0.024268,0.025530
8,14,22,1505,129877,131382,0.000164,0.006455,0.006619
9,15,24,6383,352370,358753,0.000529,0.015362,0.015891
9,14,23,2743,1162224,1164967,0.000246,0.042414,0.042660
9,13,22,9545,307957,317502,0.000849,0.011832,0.012681
10,15,25,38490,1602589,1641079,0.002924,0.059309,0.062233
10,12,22,23259,16716,39975,0.001833,0.000791,0.002624
10,15,25,57456,240787,298243,0.003722,0.010474,0.014196
10,9,19,31093,1197,32290,0.002112,0.000082,0.002194
10,13,23,51795,27326,79121,0.003432,0.002005,0.005437
7,15,22,158,532692,532850,0.000008,0.023180,0.023188
10,13,23,131111,442948,574059,0.008027,0.016283,0.024310
10,13,23,36626,11631,48257,0.002449,0.000692,0.003141
10,12,22,18770,24585,43355,0.001342,0.001377,0.002719
10,13,23,84151,314741,398892,0.005507,0.012047,0.017554
10,15,25,33337,372002,405339,0.002238,0.016389,0.018627
10,13,23,16658,647917,664575,0.001291,0.023896,0.025187
10,15,25,11114,1076914,1088028,0.000816,0.040437,0.041253
9,14,23,6904,103633,110537,0.000596,0.004136,0.004732
10,13,23,14481,58415,72896,0.001088,0.002352,0.003440
9,14,23,4421,12938,17359,0.000350,0.000945,0.001295
9,12,21,11974,240913,252887,0.000924,0.008811,0.009735
8,15,23,273,4700880,4701153,0.000027,0.180448,0.180475
9,13,22,9602,56468,66070,0.000789,0.002405,0.003194
10,13,23,28577,32376,60953,0.002029,0.001472,0.003501
10,13,23,20783,149775,170558,0.001485,0.005910,0.007395
10,13,23,43523,131055,174578,0.002743,0.005206,0.007949
11,14,25,103078,117650,220728,0.006473,0.004793,0.011266
10,14,24,26884,331322,358206,0.001820,0.012902,0.014722
9,15,24,5949,1994774,2000723,0.000515,0.071193,0.071708
10,14,24,17446,387989,405435,0.001471,0.014514,0.015985
10,13,23,41884,81268,123152,0.003230,0.003966,0.007196
9,12,21,3567,25414,28981,0.000279,0.001222,0.001501
10,13,23,35181,26425,61606,0.002642,0.001502,0.004144
10,13,23,16232,160763,176995,0.001173,0.006786,0.007959
10,13,23,19400,32475,51875,0.001415,0.001622,0.003037
10,13,23,17612,101738,119350,0.001306,0.005029,0.006335
9,13,22,3801,132796,136597,0.000286,0.004758,0.005044
10,15,25,11407,3298481,3309888,0.000952,0.121674,0.122626
10,13,23,8895,5128,14023,0.000813,0.000384,0.001197
10,14,24,19060,418800,437860,0.001294,0.016571,0.017865
9,14,23,10408,915197,925605,0.000886,0.033582,0.034468
8,14,22,740,47599,48339,0.000101,0.002024,0.002125
10,12,22,40631,1340,41971,0.002918,0.000108,0.003026
9,15,24,4300,1430881,1435181,0.000334,0.062828,0.063162
10,12,22,35694,108436,144130,0.002405,0.004079,0.006484
10,13,23,85278,301,85579,0.005898,0.000032,0.005930
10,13,23,30806,28878,59684,0.001734,0.001410,0.003144
10,16,26,10637,8416853,8427490,0.000762,0.359164,0.359926
9,13,22,5251,10606,15857,0.000491,0.000657,0.001148
10,14,24,54052,1092077,1146129,0.003486,0.050267,0.053753
10,15,25,12037,2665163,2677200,0.000960,0.117206,0.118166
10,15,25,15551,713830,729381,0.001256,0.032264,0.033520
8,13,21,2614,382205,384819,0.000212,0.015663,0.015875
10,13,23,36468,95409,131877,0.002880,0.004595,0.007475
9,14,23,5646,1409526,1415172,0.000453,0.052119,0.052572
11,14,25,156858,864538,1021396,0.009845,0.030705,0.040550
10,15,25,39141,1310277,1349418,0.002847,0.055244,0.058091
10,14,24,134416,165794,300210,0.007929,0.006433,0.014362
10,15,25,15790,2214764,2230554,0.001189,0.079236,0.080425
10,12,22,12829,140527,153356,0.001077,0.004922,0.005999
9,12,21,3891,12354,16245,0.000321,0.000647,0.000968
10,14,24,43067,174657,217724,0.002659,0.007728,0.010387
9,13,22,8488,31395,39883,0.000684,0.001516,0.002200
11,14,25,121343,3851465,3972808,0.007399,0.126967,0.134366
10,15,25,38697,1494874,1533571,0.002624,0.054017,0.056641
10,13,23,14850,110559,125409,0.001284,0.004376,0.005660
9,16,25,7062,3610650,3617712,0.000664,0.138261,0.138925
10,13,23,22937,18198,41135,0.001721,0.000989,0.002710
9,13,22,18585,286360,304945,0.001260,0.011585,0.012845
10,15,25,44241,511522,555763,0.003102,0.021839,0.024941
9,11,20,10883,11307,22190,0.000824,0.000554,0.001378
10,15,25,61296,337645,398941,0.003853,0.014002,0.017855
8,13,21,3768,74098,77866,0.000332,0.002685,0.003017
9,15,24,2637,213582,216219,0.000252,0.009050,0.009302
9,15,24,14992,2379775,2394767,0.001067,0.088669,0.089736
10,12,22,13229,7242,20471,0.001074,0.000413,0.001487
9,16,25,1800,5383076,5384876,0.000196,0.219205,0.219401
9,14,23,2212,190310,192522,0.000207,0.008026,0.008233
8,15,23,496,2563669,2564165,0.000050,0.102233,0.102283
10,14,24,10144,420988,431132,0.000777,0.016230,0.017007
9,16,25,7188,7585647,7592835,0.000581,0.267420,0.268001
9,15,24,6123,433510,439633,0.000502,0.015560,0.016062
9,14,23,3364,599143,602507,0.000297,0.020409,0.020706
9,15,24,8745,1674082,1682827,0.000689,0.056198,0.056887
10,13,23,17975,23967,41942,0.001284,0.001187,0.002471
10,13,23,35758,46397,82155,0.002261,0.002011,0.004272
10,14,24,51175,4738818,4789993,0.003105,0.164784,0.167889
9,14,23,4705,245095,249800,0.000375,0.008625,0.009000
10,14,24,29344,209830,239174,0.001978,0.007911,0.009889
8,15,23,888,3341016,3341904,0.000077,0.141529,0.141606
10,14,24,77427,254859,332286,0.005371,0.009854,0.015225
9,13,22,7480,25795,33275,0.000617,0.001323,0.001940
10,15,25,53471,672636,726107,0.003855,0.026486,0.030341
10,14,24,14470,1177494,1191964,0.001018,0.038183,0.039201
10,15,25,63587,430106,493693,0.004123,0.016433,0.020556
9,12,21,10404,21684,32088,0.000798,0.000950,0.001748
9,12,21,4306,41241,45547,0.000329,0.001839,0.002168
10,16,26,77063,3845086,3922149,0.005075,0.147845,0.152920
9,11,20,9396,26421,35817,0.000743,0.001058,0.001801
8,15,23,796,1157460,1158256,0.000060,0.045071,0.045131
10,14,24,9916,269044,278960,0.000797,0.010719,0.011516
9,15,24,7886,4739466,4747352,0.000627,0.170194,0.170821
9,15,24,741,1080527,1081268,0.000074,0.042097,0.042171
9,15,24,8176,1113412,1121588,0.000662,0.045606,0.046268
8,14,22,1658,599254,600912,0.000156,0.021300,0.021456
8,13,21,1731,434967,436698,0.000169,0.016490,0.016659
10,15,25,16227,364854,381081,0.001287,0.012621,0.013908
8,13,21,3342,114765,118107,0.000250,0.004504,0.004754
9,13,22,10628,75706,86334,0.000781,0.002862,0.003643
10,15,25,35162,1871288,1906450,0.002510,0.065685,0.068195
9,13,22,6410,78411,84821,0.000541,0.003092,0.003633
10,14,24,45919,1414920,1460839,0.003238,0.048451,0.051689
10,16,26,5056,2875155,2880211,0.000403,0.109751,0.110154
8,13,21,392,62428,62820,0.000039,0.003149,0.003188
10,16,26,12003,3098826,3110829,0.000939,0.131952,0.132891
10,13,23,16254,695,16949,0.001405,0.000070,0.001475
9,16,25,10752,1745904,1756656,0.000768,0.073222,0.073990
9,13,22,2628,197483,200111,0.000210,0.007210,0.007420
10,15,25,8452,2663319,2671771,0.000739,0.103245,0.103984
9,15,24,1981,1297368,1299349,0.000183,0.051121,0.051304
10,12,22,23487,16758,40245,0.001748,0.000735,0.002483
10,14,24,31816,493535,525351,0.002111,0.019489,0.021600
10,14,24,15546,864630,880176,0.001266,0.032392,0.033658
9,15,24,16244,3463433,3479677,0.001167,0.145125,0.146292
10,15,25,9162,415483,424645,0.000715,0.015047,0.015762
9,14,23,7885,213738,221623,0.000616,0.008159,0.008775
9,14,23,3842,1311969,1315811,0.000317,0.043819,0.044136
8,14,22,1136,1904046,1905182,0.000094,0.064861,0.064955
9,15,24,5202,761543,766745,0.000444,0.028070,0.028514
9,12,21,8319,68096,76415,0.000680,0.002619,0.003299
9,14,23,2260,170438,172698,0.000190,0.006622,0.006812
10,14,24,7993,699660,707653,0.000651,0.024867,0.025518
10,14,24,7862,516781,524643,0.000660,0.018369,0.019029
9,15,24,1660,3007888,3009548,0.000156,0.107895,0.108051
9,14,23,29222,352836,382058,0.002014,0.012913,0.014927
9,14,23,7050,167783,174833,0.000535,0.006474,0.007009
10,13,23,12653,214262,226915,0.000955,0.007900,0.008855
9,14,23,3396,221348,224744,0.000239,0.008426,0.008665
10,13,23,24232,4738,28970,0.001907,0.000295,0.002202
8,15,23,689,251287,251976,0.000054,0.010603,0.010657
10,16,26,73608,1402345,1475953,0.004316,0.060570,0.064886
10,15,25,23365,1547221,1570586,0.001828,0.054633,0.056461
10,14,24,13045,248189,261234,0.001021,0.012210,0.013231
10,15,25,6856,2293550,2300406,0.000578,0.090174,0.090752
9,14,23,2390,4065203,4067593,0.000215,0.137301,0.137516
9,14,23,6678,1236153,1242831,0.000509,0.041551,0.042060
10,14,24,15626,620300,635926,0.001182,0.019968,0.021150
9,13,22,6098,216276,222374,0.000477,0.008153,0.008630
10,13,23,23228,14789,38017,0.001785,0.001042,0.002827
8,14,22,4321,169438,173759,0.000308,0.006835,0.007143
10,15,25,45605,5627540,5673145,0.003004,0.203880,0.206884
9,15,24,6864,151700,158564,0.000591,0.006352,0.006943
10,14,24,49831,53697,103528,0.003214,0.002859,0.006073
10,13,23,13345,13507,26852,0.000920,0.000696,0.001616
9,15,24,5591,2415061,2420652,0.000412,0.091903,0.092315
9,14,23,9137,1322872,1332009,0.000689,0.044201,0.044890
10,15,25,20889,332221,353110,0.001529,0.012843,0.014372
10,15,25,14133,2260245,2274378,0.001151,0.079677,0.080828
10,13,23,7977,239703,247680,0.000640,0.009126,0.009766
9,14,23,9824,195949,205773,0.000695,0.007339,0.008034
10,13,23,52408,87247,139655,0.003750,0.003964,0.007714
10,14,24,41909,1657120,1699029,0.002829,0.058761,0.061590
9,13,22,8663,25291,33954,0.000651,0.001150,0.001801
9,14,23,2518,567940,570458,0.000191,0.021069,0.021260
10,13,23,107126,239713,346839,0.007101,0.009985,0.017086
9,15,24,1000,271844,272844,0.000094,0.013575,0.013669
10,14,24,36396,2230143,2266539,0.002588,0.089747,0.092335
10,15,25,23777,601056,624833,0.001607,0.030639,0.032246
10,15,25,13601,1951094,1964695,0.001068,0.088248,0.089316
11,14,25,97419,227878,325297,0.006501,0.010039,0.016540
10,15,25,7132,257094,264226,0.000614,0.010984,0.011598
9,15,24,3090,514313,517403,0.000251,0.024701,0.024952
10,14,24,17680,170036,187716,0.001400,0.006624,0.008024
8,14,22,629,1063829,1064458,0.000055,0.038166,0.038221
10,14,24,9265,3618553,3627818,0.000760,0.133983,0.134743
8,14,22,1125,1263457,1264582,0.000094,0.044769,0.044863
10,13,23,23113,157948,181061,0.001748,0.006473,0.008221
10,13,23,11809,69396,81205,0.000876,0.003213,0.004089
10,15,25,17634,5522833,5540467,0.001277,0.213436,0.214713
10,15,25,26019,1055614,1081633,0.002023,0.045171,0.047194
10,15,25,18750,680632,699382,0.001482,0.026886,0.028368
10,14,24,64000,104801,168801,0.004324,0.004878,0.009202
9,14,23,3036,92504,95540,0.000244,0.004512,0.004756
9,13,22,1446,76774,78220,0.000170,0.003385,0.003555
10,14,24,41894,72063,113957,0.002657,0.003673,0.006330
9,14,23,4295,772660,776955,0.000360,0.029404,0.029764
8,15,23,2842,173314,176156,0.000292,0.008391,0.008683
10,14,24,44884,624687,669571,0.003424,0.025534,0.028958
10,13,23,34161,119444,153605,0.002497,0.004771,0.007268
10,14,24,15468,783131,798599,0.001171,0.030826,0.031997
10,14,24,30605,73720,104325,0.002077,0.003361,0.005438
10,14,24,35503,146183,181686,0.002470,0.006361,0.008831
10,15,25,13075,811800,824875,0.000974,0.030614,0.031588
9,12,21,15357,39744,55101,0.001171,0.001837,0.003008
9,14,23,2197,418886,421083,0.000207,0.016839,0.017046
10,14,24,22562,693807,716369,0.002132,0.028667,0.030799
9,13,22,9896,41314,51210,0.000922,0.001968,0.002890
9,15,24,2103,1619097,1621200,0.000163,0.057026,0.057189
10,14,24,6964,12776,19740,0.000672,0.000931,0.001603
10,14,24,14285,1448620,1462905,0.001111,0.053301,0.054412
10,15,25,20023,1878002,1898025,0.001585,0.070582,0.072167
9,14,23,1694,171326,173020,0.000198,0.006751,0.006949
10,15,25,12190,423442,435632,0.000904,0.016691,0.017595
10,15,25,70911,987449,1058360,0.004495,0.039626,0.044121
10,12,22,31671,12890,44561,0.002348,0.000852,0.003200
7,14,21,577,214380,214957,0.000064,0.008589,0.008653
9,14,23,7161,1941795,1948956,0.000542,0.069708,0.070250
10,15,25,37225,802453,839678,0.002947,0.039524,0.042471
10,15,25,77768,1059454,1137222,0.005302,0.052226,0.057528
10,14,24,16747,559584,576331,0.001444,0.029271,0.030715
10,14,24,26505,101743,128248,0.002058,0.004680,0.006738
9,11,20,3695,4701,8396,0.000337,0.000304,0.000641
9,14,23,1863,9551220,9553083,0.000176,0.331733,0.331909
10,11,21,20659,1671,22330,0.001327,0.000114,0.001441
10,15,25,35782,461245,497027,0.002572,0.017994,0.020566
9,14,23,4098,139017,143115,0.000362,0.005802,0.006164
8,14,22,2599,1349393,1351992,0.000230,0.045166,0.045396
10,15,25,18386,900145,918531,0.001441,0.034084,0.035525
9,12,21,3441,14835,18276,0.000335,0.000761,0.001096
10,13,23,89310,20755,110065,0.005820,0.000977,0.006797
11,15,26,91145,4216145,4307290,0.005147,0.168632,0.173779
10,14,24,7447,135322,142769,0.000640,0.005736,0.006376
9,15,24,1138,1986632,1987770,0.000101,0.081571,0.081672
10,14,24,54616,1704891,1759507,0.003823,0.068851,0.072674
9,14,23,6564,675036,681600,0.000541,0.025129,0.025670
10,13,23,11392,12256,23648,0.000896,0.000655,0.001551
9,14,23,16221,13173,29394,0.001159,0.001028,0.002187
10,13,23,29423,74086,103509,0.002202,0.003766,0.005968
10,14,24,24479,99962,124441,0.001743,0.004727,0.006470
9,13,22,5216,111399,116615,0.000417,0.004531,0.004948
10,14,24,8607,329810,338417,0.000754,0.014062,0.014816
9,13,22,8469,19703,28172,0.000682,0.001186,0.001868
10,16,26,39792,3553006,3592798,0.002876,0.159527,0.162403
10,12,22,72277,36065,108342,0.004735,0.001998,0.006733
9,16,25,7262,4587825,4595087,0.000639,0.205780,0.206419
10,14,24,30851,184609,215460,0.002210,0.007668,0.009878
10,14,24,43187,1864970,1908157,0.003359,0.068566,0.071925
10,12,22,11907,2449,14356,0.000938,0.000207,0.001145
8,15,23,637,948585,949222,0.000082,0.050433,0.050515
9,14,23,2041,977218,979259,0.000187,0.041092,0.041279
10,13,23,17102,147379,164481,0.001428,0.006424,0.007852
10,15,25,24137,896689,920826,0.001721,0.039897,0.041618
9,12,21,3091,105027,108118,0.000321,0.004968,0.005289
10,15,25,8960,796243,805203,0.000799,0.033233,0.034032
10,14,24,44542,355402,399944,0.002736,0.018730,0.021466
9,15,24,12979,466410,479389,0.001114,0.022474,0.023588
11,14,25,92860,1301422,1394282,0.006390,0.045872,0.052262
9,13,22,828,213800,214628,0.000122,0.008558,0.008680
10,14,24,16097,107969,124066,0.001282,0.005613,0.006895
8,14,22,1756,1805692,1807448,0.000157,0.062197,0.062354
10,13,23,39927,279837,319764,0.003056,0.010881,0.013937
8,16,24,248,2308890,2309138,0.000021,0.087929,0.087950
10,15,25,42105,689288,731393,0.003091,0.028288,0.031379
10,15,25,20815,571145,591960,0.001607,0.021268,0.022875
9,14,23,3388,296091,299479,0.000318,0.011382,0.011700
9,14,23,3913,328832,332745,0.000373,0.013346,0.013719
10,15,25,13103,3437408,3450511,0.001050,0.128228,0.129278
10,14,24,14807,197330,212137,0.001177,0.007433,0.008610
9,16,25,9525,1877298,1886823,0.000751,0.080550,0.081301
9,15,24,9667,1086174,1095841,0.000806,0.042297,0.043103
7,15,22,206,682210,682416,0.000019,0.030288,0.030307
9,15,24,2604,516742,519346,0.000263,0.022363,0.022626
9,15,24,1587,1848936,1850523,0.000189,0.066969,0.067158
10,15,25,15304,1953322,1968626,0.001173,0.070418,0.071591
10,14,24,16910,392574,409484,0.001403,0.015631,0.017034
10,15,25,10163,1524947,1535110,0.000836,0.054609,0.055445
10,15,25,47360,1019046,1066406,0.003586,0.041692,0.045278
10,15,25,33571,10981683,11015254,0.002737,0.372087,0.374824
10,15,25,19162,213554,232716,0.001487,0.009319,0.010806
10,15,25,16306,1242725,1259031,0.001224,0.054206,0.055430
9,14,23,6125,100096,106221,0.000575,0.004129,0.004704
10,16,26,21677,3925590,3947267,0.001808,0.177466,0.179274
10,14,24,18269,223549,241818,0.001251,0.009332,0.010583
9,13,22,22471,1085,23556,0.001721,0.000126,0.001847
11,13,24,72600,5174,77774,0.004810,0.000288,0.005098
10,14,24,30123,652942,683065,0.002051,0.026920,0.028971
9,15,24,18495,134803,153298,0.001233,0.005756,0.006989
8,11,19,1524,9193,10717,0.000133,0.000418,0.000551
10,14,24,25737,168500,194237,0.001955,0.007426,0.009381
9,14,23,853,7533795,7534648,0.000083,0.277197,0.277280
9,15,24,10118,2796634,2806752,0.000864,0.110203,0.111067
8,14,22,545,223262,223807,0.000058,0.012694,0.012752
10,10,20,12990,966,13956,0.000996,0.000065,0.001061
10,13,23,20019,158400,178419,0.001361,0.006846,0.008207
10,15,25,37194,4778112,4815306,0.002727,0.205912,0.208639
10,14,24,16428,64976,81404,0.001279,0.002996,0.004275
10,15,25,20077,939665,959742,0.001475,0.046189,0.047664
9,14,23,5750,275675,281425,0.000518,0.014278,0.014796
10,14,24,25060,80962,106022,0.001781,0.004013,0.005794
10,16,26,16087,3393033,3409120,0.001297,0.150411,0.151708
9,14,23,12884,90784,103668,0.000934,0.004232,0.005166
11,13,24,79508,315210,394718,0.005723,0.013319,0.019042
8,14,22,398,199577,199975,0.000056,0.009262,0.009318
10,14,24,44896,880706,925602,0.003251,0.035628,0.038879
10,13,23,47671,193933,241604,0.003626,0.008001,0.011627
9,13,22,4411,384664,389075,0.000407,0.016050,0.016457
10,12,22,25887,79389,105276,0.001849,0.003422,0.005271
9,15,24,808,2610282,2611090,0.000084,0.106659,0.106743
9,13,22,10279,19788,30067,0.000871,0.000859,0.001730
9,15,24,1851,1140827,1142678,0.000172,0.041905,0.042077
10,14,24,61703,655779,717482,0.004015,0.024806,0.028821
10,13,23,15142,224989,240131,0.001118,0.008915,0.010033
10,15,25,45164,6128754,6173918,0.003101,0.218300,0.221401
10,15,25,15957,1698047,1714004,0.001235,0.071756,0.072991
9,12,21,889,26288,27177,0.000126,0.001182,0.001308
9,15,24,18460,429654,448114,0.001265,0.018113,0.019378
10,12,22,55255,3231,58486,0.004119,0.000206,0.004325
10,14,24,3961,281967,285928,0.000311,0.011013,0.011324
10,12,22,19060,782,19842,0.001414,0.000066,0.001480
9,15,24,2397,328934,331331,0.000219,0.013538,0.013757
9,14,23,6112,488856,494968,0.000523,0.017550,0.018073
9,13,22,20070,22881,42951,0.001364,0.001159,0.002523
10,16,26,14976,5530864,5545840,0.001085,0.217267,0.218352
11,15,26,94190,895792,989982,0.006294,0.033276,0.039570
10,15,25,20300,782039,802339,0.001528,0.029567,0.031095
8,15,23,1400,609968,611368,0.000151,0.026338,0.026489
9,14,23,9870,470588,480458,0.000828,0.018870,0.019698
10,13,23,13428,51263,64691,0.001161,0.002546,0.003707
10,16,26,18885,1822931,1841816,0.001600,0.073551,0.075151
9,14,23,1153,1180580,1181733,0.000150,0.043300,0.043450
9,13,22,6572,96580,103152,0.000609,0.004732,0.005341
10,13,23,28829,167979,196808,0.002451,0.006942,0.009393
10,12,22,24771,31533,56304,0.001997,0.001623,0.003620
9,15,24,3421,1200810,1204231,0.000279,0.047332,0.047611
9,14,23,973,206400,207373,0.000131,0.008979,0.009110
10,14,24,7884,2779555,2787439,0.000673,0.096194,0.096867
9,15,24,10780,589390,600170,0.000933,0.025446,0.026379
9,14,23,10662,441057,451719,0.000882,0.018924,0.019806
10,14,24,5189,969815,975004,0.000505,0.038065,0.038570
9,15,24,879,378932,379811,0.000124,0.015734,0.015858
9,15,24,8300,7999000,8007300,0.000613,0.296382,0.296995
9,13,22,2002,89887,91889,0.000224,0.004077,0.004301
9,12,21,6958,42787,49745,0.000554,0.001702,0.002256
10,14,24,22803,726658,749461,0.001776,0.026954,0.028730
10,13,23,44126,581695,625821,0.003149,0.020077,0.023226
9,14,23,4431,654096,658527,0.000416,0.023826,0.024242
10,15,25,13783,3340995,3354778,0.001232,0.122366,0.123598
10,13,23,17800,14252,32052,0.001583,0.000877,0.002460
10,14,24,37062,121568,158630,0.002903,0.005237,0.008140
9,15,24,685,649626,650311,0.000084,0.026334,0.026418
9,12,21,12409,38816,51225,0.001020,0.001714,0.002734
10,15,25,24506,636738,661244,0.001932,0.027375,0.029307
10,12,22,7957,93531,101488,0.000723,0.004168,0.004891
10,13,23,43111,267347,310458,0.003306,0.010230,0.013536
10,14,24,21775,504019,525794,0.001648,0.018506,0.020154
10,13,23,24459,6885,31344,0.001854,0.000318,0.002172
10,14,24,34120,611526,645646,0.002579,0.025185,0.027764
9,12,21,2064,2549,4613,0.000213,0.000191,0.000404
9,15,24,2446,5341513,5343959,0.000230,0.180059,0.180289
10,15,25,33036,1430644,1463680,0.002786,0.054415,0.057201
10,14,24,14836,744821,759657,0.001320,0.028159,0.029479
9,14,23,6807,596855,603662,0.000641,0.021519,0.022160
9,14,23,1207,254288,255495,0.000153,0.011319,0.011472
10,14,24,37752,14570,52322,0.002996,0.001209,0.004205
9,14,23,12151,215694,227845,0.000919,0.009811,0.010730
9,15,24,9803,239146,248949,0.000877,0.012540,0.013417
10,13,23,6598,431750,438348,0.000614,0.014295,0.014909
10,15,25,36228,1685923,1722151,0.002920,0.070261,0.073181
9,14,23,2433,4506055,4508488,0.000270,0.149276,0.149546
10,14,24,17059,504729,521788,0.001465,0.019113,0.020578
11,14,25,97700,503967,601667,0.007166,0.020767,0.027933
9,14,23,2536,335001,337537,0.000270,0.014441,0.014711
9,15,24,7876,2580054,2587930,0.000713,0.099506,0.100219
9,11,20,8428,6816,15244,0.000652,0.000388,0.001040
9,14,23,7933,1355197,1363130,0.000650,0.052572,0.053222
9,12,21,12548,10051,22599,0.000983,0.000609,0.001592
10,14,24,20095,664052,684147,0.001604,0.030418,0.032022
10,13,23,8451,154043,162494,0.000744,0.006161,0.006905
8,14,22,487,1525078,1525565,0.000046,0.064827,0.064873
10,14,24,21560,339771,361331,0.001687,0.014779,0.016466
9,13,22,6877,106158,113035,0.000519,0.004790,0.005309
10,15,25,48601,5066226,5114827,0.003511,0.204123,0.207634
9,13,22,10866,62337,73203,0.000850,0.002411,0.003261
9,14,23,4226,604343,608569,0.000372,0.026728,0.027100
8,14,22,1593,336538,338131,0.000154,0.014077,0.014231
10,13,23,11328,325354,336682,0.000936,0.012063,0.012999
11,13,24,129307,163954,293261,0.008478,0.006686,0.015164
10,15,25,11874,363657,375531,0.001052,0.019119,0.020171
10,15,25,8114,2966764,2974878,0.000762,0.114898,0.115660
10,14,24,14392,886816,901208,0.001255,0.029856,0.031111
9,13,22,9895,145310,155205,0.000746,0.005645,0.006391
9,15,24,1714,1595012,1596726,0.000177,0.061506,0.061683
10,13,23,36137,96343,132480,0.002684,0.004439,0.007123
10,14,24,13526,423519,437045,0.000968,0.016535,0.017503
9,13,22,4064,119814,123878,0.000407,0.004742,0.005149
10,15,25,35190,766932,802122,0.002652,0.028249,0.030901
9,14,23,2863,1007446,1010309,0.000285,0.042529,0.042814
9,15,24,18243,3124866,3143109,0.001364,0.112700,0.114064
10,14,24,52798,325316,378114,0.003949,0.012543,0.016492
9,14,23,5321,283611,288932,0.000496,0.011697,0.012193
10,13,23,51134,114222,165356,0.003638,0.005137,0.008775
10,14,24,20965,2147274,2168239,0.001461,0.076012,0.077473
9,13,22,3757,1920,5677,0.000405,0.000164,0.000569
10,15,25,44310,327695,372005,0.002601,0.014998,0.017599
9,16,25,2196,3083206,3085402,0.000204,0.121815,0.122019
9,13,22,1256,515618,516874,0.000160,0.019446,0.019606
8,15,23,837,980319,981156,0.000114,0.040195,0.040309
8,13,21,784,3238,4022,0.000114,0.000256,0.000370
9,14,23,2336,334937,337273,0.000240,0.012334,0.012574
9,13,22,4589,146530,151119,0.000419,0.006843,0.007262
10,14,24,15543,647540,663083,0.001350,0.025819,0.027169
8,14,22,1505,129877,131382,0.000181,0.007553,0.007734
9,15,24,6383,352370,358753,0.000574,0.017207,0.017781
9,14,23,2743,1162224,1164967,0.000273,0.043797,0.044070
9,13,22,9545,307957,317502,0.000914,0.012549,0.013463
10,15,25,38490,1602589,1641079,0.003358,0.062917,0.066275
10,12,22,23259,16716,39975,0.002002,0.000744,0.002746
10,15,25,57456,240787,298243,0.004234,0.010722,0.014956
10,9,19,31093,1197,32290,0.002388,0.000081,0.002469
10,13,23,51795,27326,79121,0.003894,0.002097,0.005991
7,15,22,158,532692,532850,0.000008,0.025022,0.025030
10,13,23,131111,442948,574059,0.009271,0.017155,0.026426
10,13,23,36626,11631,48257,0.002667,0.000665,0.003332
10,12,22,18770,24585,43355,0.001449,0.001348,0.002797
10,13,23,84151,314741,398892,0.006019,0.012232,0.018251
10,15,25,33337,372002,405339,0.002458,0.017256,0.019714
10,13,23,16658,647917,664575,0.001310,0.023808,0.025118
10,15,25,11114,1076914,1088028,0.000868,0.041641,0.042509
9,14,23,6904,103633,110537,0.000646,0.004306,0.004952
10,13,23,14481,58415,72896,0.001161,0.002430,0.003591
9,14,23,4421,12938,17359,0.000350,0.000992,0.001342
9,12,21,11974,240913,252887,0.000948,0.008475,0.009423
8,15,23,273,4700880,4701153,0.000030,0.184016,0.184046
9,13,22,9602,56468,66070,0.000767,0.002423,0.003190
10,13,23,28577,32376,60953,0.002153,0.001522,0.003675
10,13,23,20783,149775,170558,0.001522,0.006021,0.007543
10,13,23,43523,131055,174578,0.002676,0.005201,0.007877
11,14,25,103078,117650,220728,0.006851,0.004671,0.011522
10,14,24,26884,331322,358206,0.001787,0.012945,0.014732
9,15,24,5949,1994774,2000723,0.000508,0.071075,0.071583
10,14,24,17446,387989,405435,0.001542,0.015143,0.016685
10,13,23,41884,81268,123152,0.003291,0.004090,0.007381
9,12,21,3567,25414,28981,0.000304,0.001318,0.001622
10,13,23,35181,26425,61606,0.002656,0.001427,0.004083
10,13,23,16232,160763,176995,0.001162,0.006653,0.007815
10,13,23,19400,32475,51875,0.001417,0.001749,0.003166
10,13,23,17612,101738,119350,0.001349,0.004907,0.006256
9,13,22,3801,132796,136597,0.000290,0.004712,0.005002
10,15,25,11407,3298481,3309888,0.000875,0.126486,0.127361
10,13,23,8895,5128,14023,0.000830,0.000373,0.001203
10,14,24,19060,418800,437860,0.001410,0.017333,0.018743
9,14,23,10408,915197,925605,0.000877,0.033120,0.033997
8,14,22,740,47599,48339,0.000101,0.002140,0.002241
10,12,22,40631,1340,41971,0.003168,0.000098,0.003266
9,15,24,4300,1430881,1435181,0.000342,0.057715,0.058057
10,12,22,35694,108436,144130,0.002619,0.004121,0.006740
10,13,23,85278,301,85579,0.006206,0.000040,0.006246
10,13,23,30806,28878,59684,0.001870,0.001388,0.003258
10,16,26,10637,8416853,8427490,0.000754,0.334986,0.335740
9,13,22,5251,10606,15857,0.000484,0.000660,0.001144
10,14,24,54052,1092077,1146129,0.003636,0.045281,0.048917
10,15,25,12037,2665163,2677200,0.000967,0.110929,0.111896
10,15,25,15551,713830,729381,0.001203,0.030354,0.031557
8,13,21,2614,382205,384819,0.000182,0.016239,0.016421
10,13,23,36468,95409,131877,0.002796,0.004347,0.007143
9,14,23,5646,1409526,1415172,0.000458,0.054452,0.054910
11,14,25,156858,864538,1021396,0.009542,0.030862,0.040404
10,15,25,39141,1310277,1349418,0.002833,0.056017,0.058850
10,14,24,134416,165794,300210,0.007935,0.006383,0.014318
10,15,25,15790,2214764,2230554,0.001120,0.081910,0.083030
10,12,22,12829,140527,153356,0.001035,0.005011,0.006046
9,12,21,3891,12354,16245,0.000345,0.000706,0.001051
10,14,24,43067,174657,217724,0.002699,0.007408,0.010107
9,13,22,8488,31395,39883,0.000669,0.001520,0.002189
11,14,25,121343,3851465,3972808,0.007557,0.126404,0.133961
10,15,25,38697,1494874,1533571,0.002590,0.054141,0.056731
10,13,23,14850,110559,125409,0.001256,0.004336,0.005592
9,16,25,7062,3610650,3617712,0.000615,0.143531,0.144146
10,13,23,22937,18198,41135,0.001785,0.000986,0.002771
9,13,22,18585,286360,304945,0.001369,0.011913,0.013282
10,15,25,44241,511522,555763,0.003277,0.022631,0.025908
9,11,20,10883,11307,22190,0.000910,0.000578,0.001488
10,15,25,61296,337645,398941,0.003744,0.014018,0.017762
8,13,21,3768,74098,77866,0.000330,0.002685,0.003015
9,15,24,2637,213582,216219,0.000253,0.009211,0.009464
9,15,24,14992,2379775,2394767,0.001061,0.092169,0.093230
10,12,22,13229,7242,20471,0.001066,0.000415,0.001481
9,16,25,1800,5383076,5384876,0.000199,0.203535,0.203734
9,14,23,2212,190310,192522,0.000204,0.007662,0.007866
8,15,23,496,2563669,2564165,0.000045,0.096776,0.096821
10,14,24,10144,420988,431132,0.000882,0.015637,0.016519
9,16,25,7188,7585647,7592835,0.000673,0.281607,0.282280
9,15,24,6123,433510,439633,0.000592,0.019698,0.020290
9,14,23,3364,599143,602507,0.000319,0.025349,0.025668
9,15,24,8745,1674082,1682827,0.000693,0.068856,0.069549
10,13,23,17975,23967,41942,0.001338,0.001221,0.002559
10,13,23,35758,46397,82155,0.002577,0.002367,0.004944
10,14,24,51175,4738818,4789993,0.003694,0.207341,0.211035
9,14,23,4705,245095,249800,0.000376,0.010459,0.010835
10,14,24,29344,209830,239174,0.002100,0.009025,0.011125
8,15,23,888,3341016,3341904,0.000085,0.119334,0.119419
10,14,24,77427,254859,332286,0.005925,0.009332,0.015257
9,13,22,7480,25795,33275,0.000667,0.001497,0.002164
10,15,25,53471,672636,726107,0.003953,0.026959,0.030912
10,14,24,14470,1177494,1191964,0.001031,0.038993,0.040024
10,15,25,63587,430106,493693,0.004152,0.016555,0.020707
9,12,21,10404,21684,32088,0.000819,0.000918,0.001737
9,12,21,4306,41241,45547,0.000382,0.001820,0.002202
10,16,26,77063,3845086,3922149,0.005150,0.151488,0.156638
9,11,20,9396,26421,35817,0.000794,0.001040,0.001834
8,15,23,796,1157460,1158256,0.000064,0.042322,0.042386
10,14,24,9916,269044,278960,0.000880,0.010851,0.011731
9,15,24,7886,4739466,4747352,0.000664,0.178867,0.179531
9,15,24,741,1080527,1081268,0.000076,0.044563,0.044639
9,15,24,8176,1113412,1121588,0.000702,0.042495,0.043197
8,14,22,1658,599254,600912,0.000165,0.022122,0.022287
8,13,21,1731,434967,436698,0.000159,0.016240,0.016399
10,15,25,16227,364854,381081,0.001452,0.013216,0.014668
8,13,21,3342,114765,118107,0.000261,0.004777,0.005038
9,13,22,10628,75706,86334,0.000882,0.003005,0.003887
10,15,25,35162,1871288,1906450,0.002864,0.068498,0.071362
9,13,22,6410,78411,84821,0.000582,0.003345,0.003927
10,14,24,45919,1414920,1460839,0.003770,0.051420,0.055190
10,16,26,5056,2875155,2880211,0.000452,0.110680,0.111132
8,13,21,392,62428,62820,0.000041,0.002860,0.002901
10,16,26,12003,3098826,3110829,0.001050,0.126702,0.127752
10,13,23,16254,695,16949,0.001395,0.000057,0.001452
9,16,25,10752,1745904,1756656,0.000950,0.070788,0.071738
9,13,22,2628,197483,200111,0.000220,0.007549,0.007769
10,15,25,8452,2663319,2671771,0.000724,0.095779,0.096503
9,15,24,1981,1297368,1299349,0.000189,0.047611,0.047800
10,12,22,23487,16758,40245,0.001982,0.000743,0.002725
10,14,24,31816,493535,525351,0.002561,0.019306,0.021867
10,14,24,15546,864630,880176,0.001334,0.031094,0.032428
9,15,24,16244,3463433,3479677,0.001356,0.130611,0.131967
10,15,25,9162,415483,424645,0.000820,0.016061,0.016881
9,14,23,7885,213738,221623,0.000668,0.011462,0.012130
9,14,23,3842,1311969,1315811,0.000382,0.052595,0.052977
8,14,22,1136,1904046,1905182,0.000099,0.068598,0.068697
9,15,24,5202,761543,766745,0.000484,0.029854,0.030338
9,12,21,8319,68096,76415,0.000728,0.002712,0.003440
9,14,23,2260,170438,172698,0.000205,0.007244,0.007449
10,14,24,7993,699660,707653,0.000735,0.026231,0.026966
10,14,24,7862,516781,524643,0.000708,0.019752,0.020460
9,15,24,1660,3007888,3009548,0.000171,0.113407,0.113578
9,14,23,29222,352836,382058,0.002335,0.014310,0.016645
9,14,23,7050,167783,174833,0.000567,0.007181,0.007748
10,13,23,12653,214262,226915,0.001060,0.008605,0.009665
9,14,23,3396,221348,224744,0.000249,0.009432,0.009681
10,13,23,24232,4738,28970,0.002051,0.000262,0.002313
8,15,23,689,251287,251976,0.000056,0.009907,0.009963
10,16,26,73608,1402345,1475953,0.005109,0.057534,0.062643
10,15,25,23365,1547221,1570586,0.002141,0.053423,0.055564
10,14,24,13045,248189,261234,0.001133,0.010745,0.011878
10,15,25,6856,2293550,2300406,0.000704,0.086707,0.087411
9,14,23,2390,4065203,4067593,0.000220,0.135000,0.135220
9,14,23,6678,1236153,1242831,0.000552,0.042740,0.043292
10,14,24,15626,620300,635926,0.001410,0.020802,0.022212
9,13,22,6098,216276,222374,0.000505,0.008669,0.009174
10,13,23,23228,14789,38017,0.002020,0.001065,0.003085
8,14,22,4321,169438,173759,0.000371,0.007419,0.007790
10,15,25,45605,5627540,5673145,0.003542,0.218667,0.222209
9,15,24,6864,151700,158564,0.000641,0.006947,0.007588
10,14,24,49831,53697,103528,0.003842,0.003017,0.006859
10,13,23,13345,13507,26852,0.001022,0.000755,0.001777
9,15,24,5591,2415061,2420652,0.000455,0.095919,0.096374
9,14,23,9137,1322872,1332009,0.000767,0.045227,0.045994
10,15,25,20889,332221,353110,0.001711,0.013437,0.015148
10,15,25,14133,2260245,2274378,0.001229,0.081666,0.082895
10,13,23,7977,239703,247680,0.000700,0.009661,0.010361
9,14,23,9824,195949,205773,0.000735,0.007749,0.008484
10,13,23,52408,87247,139655,0.004090,0.004337,0.008427
10,14,24,41909,1657120,1699029,0.003268,0.059475,0.062743
9,13,22,8663,25291,33954,0.000738,0.001141,0.001879
9,14,23,2518,567940,570458,0.000206,0.023785,0.023991
10,13,23,107126,239713,346839,0.009011,0.012453,0.021464
9,15,24,1000,271844,272844,0.000093,0.011726,0.011819
10,14,24,36396,2230143,2266539,0.002857,0.093399,0.096256
10,15,25,23777,601056,624833,0.001704,0.032902,0.034606
10,15,25,13601,1951094,1964695,0.001147,0.086502,0.087649
11,14,25,97419,227878,325297,0.006644,0.009383,0.016027
10,15,25,7132,257094,264226,0.000739,0.010702,0.011441
9,15,24,3090,514313,517403,0.000249,0.023461,0.023710
10,14,24,17680,170036,187716,0.001450,0.006602,0.008052
8,14,22,629,1063829,1064458,0.000056,0.034886,0.034942
10,14,24,9265,3618553,3627818,0.000775,0.125615,0.126390
8,14,22,1125,1263457,1264582,0.000092,0.042625,0.042717
10,13,23,23113,157948,181061,0.001965,0.006435,0.008400
10,13,23,11809,69396,81205,0.000894,0.003310,0.004204
10,15,25,17634,5522833,5540467,0.001348,0.203414,0.204762
10,15,25,26019,1055614,1081633,0.002405,0.046547,0.048952
10,15,25,18750,680632,699382,0.001759,0.027880,0.029639
10,14,24,64000,104801,168801,0.005212,0.005306,0.010518
9,14,23,3036,92504,95540,0.000251,0.005198,0.005449
9,13,22,1446,76774,78220,0.000151,0.003797,0.003948
10,14,24,41894,72063,113957,0.003380,0.003995,0.007375
9,14,23,4295,772660,776955,0.000382,0.031458,0.031840
8,15,23,2842,173314,176156,0.000329,0.009047,0.009376
10,14,24,44884,624687,669571,0.003972,0.028209,0.032181
10,13,23,34161,119444,153605,0.003006,0.005380,0.008386
10,14,24,15468,783131,798599,0.001316,0.034463,0.035779
10,14,24,30605,73720,104325,0.002488,0.003548,0.006036
10,14,24,35503,146183,181686,0.002950,0.007413,0.010363
10,15,25,13075,811800,824875,0.001080,0.032944,0.034024
9,12,21,15357,39744,55101,0.001377,0.001914,0.003291
9,14,23,2197,418886,421083,0.000225,0.017164,0.017389
10,14,24,22562,693807,716369,0.002102,0.027064,0.029166
9,13,22,9896,41314,51210,0.000981,0.001890,0.002871
9,15,24,2103,1619097,1621200,0.000201,0.058491,0.058692
10,14,24,6964,12776,19740,0.000721,0.000971,0.001692
10,14,24,14285,1448620,1462905,0.001234,0.056006,0.057240
10,15,25,20023,1878002,1898025,0.001888,0.075074,0.076962
9,14,23,1694,171326,173020,0.000207,0.007066,0.007273
10,15,25,12190,423442,435632,0.001102,0.017539,0.018641
10,15,25,70911,987449,1058360,0.005562,0.043396,0.048958
10,12,22,31671,12890,44561,0.002791,0.000842,0.003633
7,14,21,577,214380,214957,0.000061,0.009243,0.009304
9,14,23,7161,1941795,1948956,0.000610,0.067736,0.068346
10,15,25,37225,802453,839678,0.003119,0.031210,0.034329
10,15,25,77768,1059454,1137222,0.006108,0.044769,0.050877
10,14,24,16747,559584,576331,0.001574,0.026761,0.028335
10,14,24,26505,101743,128248,0.002443,0.004312,0.006755
9,11,20,3695,4701,8396,0.000339,0.000291,0.000630
9,14,23,1863,9551220,9553083,0.000187,0.315350,0.315537
10,11,21,20659,1671,22330,0.001526,0.000113,0.001639
10,15,25,35782,461245,497027,0.003132,0.019083,0.022215
9,14,23,4098,139017,143115,0.000412,0.006832,0.007244
8,14,22,2599,1349393,1351992,0.000234,0.048572,0.048806
10,15,25,18386,900145,918531,0.001658,0.034987,0.036645
9,12,21,3441,14835,18276,0.000362,0.000816,0.001178
10,13,23,89310,20755,110065,0.007066,0.001025,0.008091
11,15,26,91145,4216145,4307290,0.006157,0.160135,0.166292
10,14,24,7447,135322,142769,0.000752,0.006105,0.006857
9,15,24,1138,1986632,1987770,0.000117,0.077210,0.077327
10,14,24,54616,1704891,1759507,0.004616,0.066179,0.070795
9,14,23,6564,675036,681600,0.000634,0.024645,0.025279
10,13,23,11392,12256,23648,0.001039,0.000665,0.001704
9,14,23,16221,13173,29394,0.001313,0.001006,0.002319
10,13,23,29423,74086,103509,0.002355,0.003782,0.006137
10,14,24,24479,99962,124441,0.001943,0.005097,0.007040
9,13,22,5216,111399,116615,0.000433,0.005104,0.005537
10,14,24,8607,329810,338417,0.000791,0.014186,0.014977
9,13,22,8469,19703,28172,0.000725,0.001147,0.001872
10,16,26,39792,3553006,3592798,0.003159,0.140778,0.143937
10,12,22,72277,36065,108342,0.005269,0.001945,0.007214
9,16,25,7262,4587825,4595087,0.000582,0.180899,0.181481
10,14,24,30851,184609,215460,0.002603,0.007898,0.010501
10,14,24,43187,1864970,1908157,0.003790,0.062642,0.066432
10,12,22,11907,2449,14356,0.001166,0.000204,0.001370
8,15,23,637,948585,949222,0.000079,0.043497,0.043576
9,14,23,2041,977218,979259,0.000255,0.037334,0.037589
10,13,23,17102,147379,164481,0.001674,0.005940,0.007614
10,15,25,24137,896689,920826,0.001925,0.034975,0.036900
9,12,21,3091,105027,108118,0.000343,0.004610,0.004953
10,15,25,8960,796243,805203,0.000840,0.030621,0.031461
10,14,24,44542,355402,399944,0.003084,0.015618,0.018702
9,15,24,12979,466410,479389,0.001157,0.020148,0.021305
11,14,25,92860,1301422,1394282,0.007081,0.047311,0.054392
9,13,22,828,213800,214628,0.000120,0.009567,0.009687
10,14,24,16097,107969,124066,0.001571,0.006478,0.008049
8,14,22,1756,1805692,1807448,0.000173,0.064449,0.064622
10,13,23,39927,279837,319764,0.003424,0.011064,0.014488
8,16,24,248,2308890,2309138,0.000019,0.092612,0.092631
10,15,25,42105,689288,731393,0.003602,0.030041,0.033643
10,15,25,20815,571145,591960,0.001796,0.022629,0.024425
9,14,23,3388,296091,299479,0.000312,0.012289,0.012601
9,14,23,3913,328832,332745,0.000483,0.014432,0.014915
10,15,25,13103,3437408,3450511,0.001221,0.130307,0.131528
10,14,24,14807,197330,212137,0.001341,0.008245,0.009586
9,16,25,9525,1877298,1886823,0.000809,0.079086,0.079895
9,15,24,9667,1086174,1095841,0.000926,0.042390,0.043316
7,15,22,206,682210,682416,0.000020,0.041631,0.041651
9,15,24,2604,516742,519346,0.000250,0.023674,0.023924
9,15,24,1587,1848936,1850523,0.000182,0.068933,0.069115
10,15,25,15304,1953322,1968626,0.001403,0.073196,0.074599
10,14,24,16910,392574,409484,0.001589,0.016711,0.018300
10,15,25,10163,1524947,1535110,0.000925,0.056353,0.057278
10,15,25,47360,1019046,1066406,0.004038,0.043685,0.047723
10,15,25,33571,10981683,11015254,0.002880,0.349170,0.352050
10,15,25,19162,213554,232716,0.001777,0.009642,0.011419
10,15,25,16306,1242725,1259031,0.001279,0.052379,0.053658
9,14,23,6125,100096,106221,0.000668,0.004259,0.004927
10,16,26,21677,3925590,3947267,0.002015,0.163710,0.165725
10,14,24,18269,223549,241818,0.001299,0.010280,0.011579
9,13,22,22471,1085,23556,0.001521,0.000093,0.001614
11,13,24,72600,5174,77774,0.004844,0.000285,0.005129
10,14,24,30123,652942,683065,0.002254,0.027013,0.029267
9,15,24,18495,134803,153298,0.001376,0.005964,0.007340
8,11,19,1524,9193,10717,0.000129,0.000459,0.000588
10,14,24,25737,168500,194237,0.001911,0.007589,0.009500
9,14,23,853,7533795,7534648,0.000090,0.283134,0.283224
9,15,24,10118,2796634,2806752,0.000954,0.109911,0.110865
8,14,22,545,223262,223807,0.000076,0.010505,0.010581
10,10,20,12990,966,13956,0.001272,0.000068,0.001340
10,13,23,20019,158400,178419,0.001722,0.007729,0.009451
10,15,25,37194,4778112,4815306,0.003287,0.211573,0.214860
10,14,24,16428,64976,81404,0.001276,0.003044,0.004320
10,15,25,20077,939665,959742,0.001477,0.053152,0.054629
9,14,23,5750,275675,281425,0.000560,0.013143,0.013703
10,14,24,25060,80962,106022,0.001840,0.003994,0.005834
10,16,26,16087,3393033,3409120,0.001235,0.129268,0.130503
9,14,23,12884,90784,103668,0.001150,0.004454,0.005604
11,13,24,79508,315210,394718,0.006053,0.013871,0.019924
8,14,22,398,199577,199975,0.000053,0.008896,0.008949
10,14,24,44896,880706,925602,0.003612,0.033717,0.037329
10,13,23,47671,193933,241604,0.003887,0.009029,0.012916
9,13,22,4411,384664,389075,0.000420,0.016110,0.016530
10,12,22,25887,79389,105276,0.002031,0.003868,0.005899
9,15,24,808,2610282,2611090,0.000082,0.100758,0.100840
9,13,22,10279,19788,30067,0.000923,0.000963,0.001886
9,15,24,1851,1140827,1142678,0.000183,0.046175,0.046358
10,14,24,61703,655779,717482,0.004172,0.025945,0.030117
10,13,23,15142,224989,240131,0.001124,0.008810,0.009934
10,15,25,45164,6128754,6173918,0.003381,0.226285,0.229666
10,15,25,15957,1698047,1714004,0.001431,0.082469,0.083900
9,12,21,889,26288,27177,0.000096,0.001391,0.001487
9,15,24,18460,429654,448114,0.001335,0.020746,0.022081
10,12,22,55255,3231,58486,0.003873,0.000197,0.004070
10,14,24,3961,281967,285928,0.000327,0.010935,0.011262
10,12,22,19060,782,19842,0.001573,0.000088,0.001661
9,15,24,2397,328934,331331,0.000209,0.013563,0.013772
9,14,23,6112,488856,494968,0.000534,0.017383,0.017917
9,13,22,20070,22881,42951,0.001469,0.001244,0.002713
10,16,26,14976,5530864,5545840,0.001112,0.239989,0.241101
11,15,26,94190,895792,989982,0.006214,0.035153,0.041367
10,15,25,20300,782039,802339,0.001562,0.030401,0.031963
8,15,23,1400,609968,611368,0.000168,0.028096,0.028264
9,14,23,9870,470588,480458,0.000828,0.018323,0.019151
10,13,23,13428,51263,64691,0.001051,0.002499,0.003550
10,16,26,18885,1822931,1841816,0.001577,0.085284,0.086861
9,14,23,1153,1180580,1181733,0.000120,0.048608,0.048728
9,13,22,6572,96580,103152,0.000572,0.006154,0.006726
10,13,23,28829,167979,196808,0.002394,0.008984,0.011378
10,12,22,24771,31533,56304,0.001900,0.001635,0.003535
9,15,24,3421,1200810,1204231,0.000244,0.054169,0.054413
9,14,23,973,206400,207373,0.000131,0.009990,0.010121
10,14,24,7884,2779555,2787439,0.000733,0.116172,0.116905
9,15,24,10780,589390,600170,0.000856,0.027005,0.027861
9,14,23,10662,441057,451719,0.000739,0.020424,0.021163
10,14,24,5189,969815,975004,0.000463,0.038242,0.038705
9,15,24,879,378932,379811,0.000107,0.016052,0.016159
9,15,24,8300,7999000,8007300,0.000603,0.322813,0.323416
9,13,22,2002,89887,91889,0.000194,0.004168,0.004362
9,12,21,6958,42787,49745,0.000553,0.001812,0.002365
10,14,24,22803,726658,749461,0.001908,0.031507,0.033415
10,13,23,44126,581695,625821,0.003257,0.022782,0.026039
9,14,23,4431,654096,658527,0.000417,0.028127,0.028544
10,15,25,13783,3340995,3354778,0.001170,0.135387,0.136557
10,13,23,17800,14252,32052,0.001456,0.000871,0.002327
10,14,24,37062,121568,158630,0.002682,0.005088,0.007770
9,15,24,685,649626,650311,0.000075,0.025820,0.025895
9,12,21,12409,38816,51225,0.001003,0.001747,0.002750
10,15,25,24506,636738,661244,0.001736,0.026191,0.027927
10,12,22,7957,93531,101488,0.000724,0.004110,0.004834
10,13,23,43111,267347,310458,0.003014,0.009785,0.012799
10,14,24,21775,504019,525794,0.001593,0.018425,0.020018
10,13,23,24459,6885,31344,0.001789,0.000310,0.002099
10,14,24,34120,611526,645646,0.002293,0.024760,0.027053
9,12,21,2064,2549,4613,0.000189,0.000204,0.000393
9,15,24,2446,5341513,5343959,0.000227,0.189078,0.189305
10,15,25,33036,1430644,1463680,0.002825,0.055947,0.058772
10,14,24,14836,744821,759657,0.001369,0.029025,0.030394
9,14,23,6807,596855,603662,0.000653,0.022224,0.022877
9,14,23,1207,254288,255495,0.000143,0.011610,0.011753
10,14,24,37752,14570,52322,0.003152,0.001231,0.004383
9,14,23,12151,215694,227845,0.000974,0.010070,0.011044
9,15,24,9803,239146,248949,0.000844,0.012858,0.013702
10,13,23,6598,431750,438348,0.000626,0.014915,0.015541
10,15,25,36228,1685923,1722151,0.003045,0.072732,0.075777
9,14,23,2433,4506055,4508488,0.000281,0.141389,0.141670
10,14,24,17059,504729,521788,0.001561,0.019940,0.021501
11,14,25,97700,503967,601667,0.007834,0.021296,0.029130
9,14,23,2536,335001,337537,0.000271,0.015169,0.015440
9,15,24,7876,2580054,2587930,0.000796,0.093921,0.094717
9,11,20,8428,6816,15244,0.000785,0.000426,0.001211
9,14,23,7933,1355197,1363130,0.000811,0.048140,0.048951
9,12,21,12548,10051,22599,0.001229,0.000539,0.001768
10,14,24,20095,664052,684147,0.001731,0.028312,0.030043
10,13,23,8451,154043,162494,0.000834,0.006333,0.007167
8,14,22,487,1525078,1525565,0.000058,0.057373,0.057431
10,14,24,21560,339771,361331,0.001873,0.014408,0.016281
9,13,22,6877,106158,113035,0.000601,0.004677,0.005278
10,15,25,48601,5066226,5114827,0.003922,0.194228,0.198150
9,13,22,10866,62337,73203,0.001008,0.002634,0.003642
9,14,23,4226,604343,608569,0.000390,0.026071,0.026461
8,14,22,1593,336538,338131,0.000172,0.014445,0.014617
10,13,23,11328,325354,336682,0.001018,0.012229,0.013247
11,13,24,129307,163954,293261,0.010104,0.007673,0.017777
10,15,25,11874,363657,375531,0.001037,0.019334,0.020371
10,15,25,8114,2966764,2974878,0.000748,0.113614,0.114362
10,14,24,14392,886816,901208,0.001390,0.031674,0.033064
9,13,22,9895,145310,155205,0.000908,0.006033,0.006941
9,15,24,1714,1595012,1596726,0.000157,0.065652,0.065809
10,13,23,36137,96343,132480,0.003229,0.005140,0.008369
10,14,24,13526,423519,437045,0.001107,0.018533,0.019640
9,13,22,4064,119814,123878,0.000405,0.005039,0.005444
10,15,25,35190,766932,802122,0.003045,0.030588,0.033633
9,14,23,2863,1007446,1010309,0.000279,0.038434,0.038713
9,15,24,18243,3124866,3143109,0.001576,0.114769,0.116345
10,14,24,52798,325316,378114,0.004572,0.013751,0.018323
9,14,23,5321,283611,288932,0.000545,0.012938,0.013483
10,13,23,51134,114222,165356,0.004218,0.005639,0.009857
10,14,24,20965,2147274,2168239,0.001671,0.078643,0.080314
9,13,22,3757,1920,5677,0.000406,0.000159,0.000565
10,15,25,44310,327695,372005,0.002775,0.015997,0.018772
9,16,25,2196,3083206,3085402,0.000225,0.123130,0.123355
9,13,22,1256,515618,516874,0.000180,0.020057,0.020237
8,15,23,837,980319,981156,0.000082,0.040635,0.040717
8,13,21,784,3238,4022,0.000108,0.000255,0.000363
9,14,23,2336,334937,337273,0.000254,0.012790,0.013044
9,13,22,4589,146530,151119,0.000428,0.006900,0.007328
10,14,24,15543,647540,663083,0.001477,0.032652,0.034129
8,14,22,1505,129877,131382,0.000161,0.006951,0.007112
9,15,24,6383,352370,358753,0.000560,0.016774,0.017334
9,14,23,2743,1162224,1164967,0.000267,0.043675,0.043942
9,13,22,9545,307957,317502,0.000940,0.012667,0.013607
10,15,25,38490,1602589,1641079,0.003489,0.063781,0.067270
10,12,22,23259,16716,39975,0.002223,0.000775,0.002998
10,15,25,57456,240787,298243,0.004314,0.011201,0.015515
10,9,19,31093,1197,32290,0.002399,0.000080,0.002479
10,13,23,51795,27326,79121,0.004055,0.002129,0.006184
7,15,22,158,532692,532850,0.000008,0.026513,0.026521
10,13,23,131111,442948,574059,0.009548,0.017665,0.027213
10,13,23,36626,11631,48257,0.002773,0.000675,0.003448
10,12,22,18770,24585,43355,0.001515,0.001379,0.002894
10,13,23,84151,314741,398892,0.005826,0.012019,0.017845
10,15,25,33337,372002,405339,0.002255,0.016743,0.018998
10,13,23,16658,647917,664575,0.001325,0.024126,0.025451
10,15,25,11114,1076914,1088028,0.000894,0.042238,0.043132
9,14,23,6904,103633,110537,0.000668,0.004606,0.005274
10,13,23,14481,58415,72896,0.001253,0.002610,0.003863
9,14,23,4421,12938,17359,0.000391,0.001013,0.001404
9,12,21,11974,240913,252887,0.001007,0.008625,0.009632
8,15,23,273,4700880,4701153,0.000029,0.180273,0.180302
9,13,22,9602,56468,66070,0.000904,0.002462,0.003366
10,13,23,28577,32376,60953,0.002483,0.001513,0.003996
10,13,23,20783,149775,170558,0.001825,0.006279,0.008104
10,13,23,43523,131055,174578,0.003163,0.005589,0.008752
11,14,25,103078,117650,220728,0.007841,0.004929,0.012770
10,14,24,26884,331322,358206,0.002039,0.014433,0.016472
9,15,24,5949,1994774,2000723,0.000562,0.072502,0.073064
10,14,24,17446,387989,405435,0.001648,0.015330,0.016978
10,13,23,41884,81268,123152,0.003612,0.004333,0.007945
9,12,21,3567,25414,28981,0.000297,0.001344,0.001641
10,13,23,35181,26425,61606,0.002996,0.001486,0.004482
10,13,23,16232,160763,176995,0.001395,0.007717,0.009112
10,13,23,19400,32475,51875,0.001549,0.001792,0.003341
10,13,23,17612,101738,119350,0.001518,0.005597,0.007115
9,13,22,3801,132796,136597,0.000292,0.005137,0.005429
10,15,25,11407,3298481,3309888,0.000965,0.127992,0.128957
10,13,23,8895,5128,14023,0.000849,0.000369,0.001218
10,14,24,19060,418800,437860,0.001562,0.017977,0.019539
9,14,23,10408,915197,925605,0.000925,0.034637,0.035562
8,14,22,740,47599,48339,0.000103,0.002228,0.002331
10,12,22,40631,1340,41971,0.003389,0.000090,0.003479
9,15,24,4300,1430881,1435181,0.000366,0.059401,0.059767
10,12,22,35694,108436,144130,0.003018,0.005354,0.008372
10,13,23,85278,301,85579,0.007041,0.000029,0.007070
10,13,23,30806,28878,59684,0.001930,0.001510,0.003440
10,16,26,10637,8416853,8427490,0.000824,0.344958,0.345782
9,13,22,5251,10606,15857,0.000545,0.000715,0.001260
10,14,24,54052,1092077,1146129,0.004226,0.040776,0.045002
10,15,25,12037,2665163,2677200,0.001100,0.103312,0.104412
10,15,25,15551,713830,729381,0.001455,0.029540,0.030995
8,13,21,2614,382205,384819,0.000229,0.015030,0.015259
10,13,23,36468,95409,131877,0.003213,0.004692,0.007905
9,14,23,5646,1409526,1415172,0.000499,0.053626,0.054125
11,14,25,156858,864538,1021396,0.011462,0.033420,0.044882
10,15,25,39141,1310277,1349418,0.003276,0.058992,0.062268
10,14,24,134416,165794,300210,0.009379,0.007067,0.016446
10,15,25,15790,2214764,2230554,0.001248,0.082556,0.083804
10,12,22,12829,140527,153356,0.001198,0.005075,0.006273
9,12,21,3891,12354,16245,0.000343,0.000662,0.001005
10,14,24,43067,174657,217724,0.003236,0.008522,0.011758
9,13,22,8488,31395,39883,0.000732,0.001580,0.002312
11,14,25,121343,3851465,3972808,0.009082,0.129503,0.138585
10,15,25,38697,1494874,1533571,0.003192,0.065542,0.068734
10,13,23,14850,110559,125409,0.001500,0.004588,0.006088
9,16,25,7062,3610650,3617712,0.000629,0.148323,0.148952
10,13,23,22937,18198,41135,0.001982,0.000987,0.002969
9,13,22,18585,286360,304945,0.001440,0.012689,0.014129
10,15,25,44241,511522,555763,0.003574,0.024720,0.028294
9,11,20,10883,11307,22190,0.001024,0.000612,0.001636
10,15,25,61296,337645,398941,0.004610,0.015699,0.020309
8,13,21,3768,74098,77866,0.000343,0.002717,0.003060
9,15,24,2637,213582,216219,0.000250,0.009914,0.010164
9,15,24,14992,2379775,2394767,0.001211,0.094438,0.095649
10,12,22,13229,7242,20471,0.001246,0.000424,0.001670
9,16,25,1800,5383076,5384876,0.000189,0.209142,0.209331
9,14,23,2212,190310,192522,0.000198,0.007306,0.007504
8,15,23,496,2563669,2564165,0.000047,0.095792,0.095839
10,14,24,10144,420988,431132,0.000780,0.014937,0.015717
9,16,25,7188,7585647,7592835,0.000570,0.264055,0.264625
9,15,24,6123,433510,439633,0.000512,0.015084,0.015596
9,14,23,3364,599143,602507,0.000318,0.020848,0.021166
9,15,24,8745,1674082,1682827,0.000711,0.055943,0.056654
10,13,23,17975,23967,41942,0.001275,0.001157,0.002432
10,13,23,35758,46397,82155,0.002256,0.001999,0.004255
10,14,24,51175,4738818,4789993,0.003213,0.168171,0.171384
9,14,23,4705,245095,249800,0.000378,0.008474,0.008852
10,14,24,29344,209830,239174,0.001993,0.008097,0.010090
8,15,23,888,3341016,3341904,0.000075,0.119068,0.119143
10,14,24,77427,254859,332286,0.005964,0.010383,0.016347
9,13,22,7480,25795,33275,0.000595,0.001333,0.001928
10,15,25,53471,672636,726107,0.003819,0.027725,0.031544
10,14,24,14470,1177494,1191964,0.001045,0.039432,0.040477
10,15,25,63587,430106,493693,0.004190,0.016739,0.020929
9,12,21,10404,21684,32088,0.000812,0.000966,0.001778
9,12,21,4306,41241,45547,0.000333,0.001841,0.002174
10,16,26,77063,3845086,3922149,0.005091,0.149946,0.155037
9,11,20,9396,26421,35817,0.000717,0.001002,0.001719
8,15,23,796,1157460,1158256,0.000059,0.041839,0.041898
10,14,24,9916,269044,278960,0.000795,0.010146,0.010941
9,15,24,7886,4739466,4747352,0.000615,0.170269,0.170884
9,15,24,741,1080527,1081268,0.000075,0.041806,0.041881
9,15,24,8176,1113412,1121588,0.000706,0.041513,0.042219
8,14,22,1658,599254,600912,0.000155,0.021204,0.021359
8,13,21,1731,434967,436698,0.000153,0.015443,0.015596
10,15,25,16227,364854,381081,0.001300,0.012687,0.013987
8,13,21,3342,114765,118107,0.000289,0.004593,0.004882
9,13,22,10628,75706,86334,0.000789,0.002915,0.003704
10,15,25,35162,1871288,1906450,0.002615,0.066358,0.068973
9,13,22,6410,78411,84821,0.000533,0.003127,0.003660
10,14,24,45919,1414920,1460839,0.003291,0.049391,0.052682
10,16,26,5056,2875155,2880211,0.000406,0.105857,0.106263
8,13,21,392,62428,62820,0.000047,0.002675,0.002722
10,16,26,12003,3098826,3110829,0.000935,0.130301,0.131236
10,13,23,16254,695,16949,0.001259,0.000064,0.001323
9,16,25,10752,1745904,1756656,0.000726,0.071888,0.072614
9,13,22,2628,197483,200111,0.000205,0.007161,0.007366
10,15,25,8452,2663319,2671771,0.000661,0.094518,0.095179
9,15,24,1981,1297368,1299349,0.000181,0.046507,0.046688
10,12,22,23487,16758,40245,0.001804,0.000733,0.002537
10,14,24,31816,493535,525351,0.002135,0.018376,0.020511
10,14,24,15546,864630,880176,0.001224,0.030525,0.031749
9,15,24,16244,3463433,3479677,0.001178,0.128718,0.129896
10,15,25,9162,415483,424645,0.000719,0.015174,0.015893
9,14,23,7885,213738,221623,0.000623,0.008431,0.009054
9,14,23,3842,1311969,1315811,0.000320,0.044399,0.044719
8,14,22,1136,1904046,1905182,0.000095,0.065673,0.065768
9,15,24,5202,761543,766745,0.000455,0.028368,0.028823
9,12,21,8319,68096,76415,0.000692,0.002718,0.003410
9,14,23,2260,170438,172698,0.000194,0.007028,0.007222
10,14,24,7993,699660,707653,0.000655,0.024804,0.025459
10,14,24,7862,516781,524643,0.000659,0.018506,0.019165
9,15,24,1660,3007888,3009548,0.000154,0.108922,0.109076
9,14,23,29222,352836,382058,0.001927,0.013238,0.015165
9,14,23,7050,167783,174833,0.000562,0.006488,0.007050
10,13,23,12653,214262,226915,0.000957,0.007989,0.008946
9,14,23,3396,221348,224744,0.000243,0.008407,0.008650
10,13,23,24232,4738,28970,0.001805,0.000261,0.002066
8,15,23,689,251287,251976,0.000051,0.009852,0.009903
10,16,26,73608,1402345,1475953,0.004426,0.053994,0.058420
10,15,25,23365,1547221,1570586,0.001757,0.052325,0.054082
10,14,24,13045,248189,261234,0.001015,0.010721,0.011736
10,15,25,6856,2293550,2300406,0.000581,0.087336,0.087917
9,14,23,2390,4065203,4067593,0.000214,0.154267,0.154481
9,14,23,6678,1236153,1242831,0.000514,0.042358,0.042872
10,14,24,15626,620300,635926,0.001187,0.020474,0.021661
9,13,22,6098,216276,222374,0.000485,0.008320,0.008805
10,13,23,23228,14789,38017,0.001810,0.001046,0.002856
8,14,22,4321,169438,173759,0.000313,0.006441,0.006754
10,15,25,45605,5627540,5673145,0.002980,0.205835,0.208815
9,15,24,6864,151700,158564,0.000589,0.006287,0.006876
10,14,24,49831,53697,103528,0.003244,0.003020,0.006264
10,13,23,13345,13507,26852,0.000971,0.000728,0.001699
9,15,24,5591,2415061,2420652,0.000430,0.092695,0.093125
9,14,23,9137,1322872,1332009,0.000684,0.045035,0.045719
10,15,25,20889,332221,353110,0.001481,0.013068,0.014549
10,15,25,14133,2260245,2274378,0.001335,0.079962,0.081297
10,13,23,7977,239703,247680,0.000630,0.008865,0.009495
9,14,23,9824,195949,205773,0.000675,0.007329,0.008004
10,13,23,52408,87247,139655,0.003531,0.003969,0.007500
10,14,24,41909,1657120,1699029,0.002987,0.057252,0.060239
9,13,22,8663,25291,33954,0.000658,0.001128,0.001786
9,14,23,2518,567940,570458,0.000195,0.021502,0.021697
10,13,23,107126,239713,346839,0.006802,0.009234,0.016036
9,15,24,1000,271844,272844,0.000082,0.010768,0.010850
10,14,24,36396,2230143,2266539,0.002540,0.079624,0.082164
10,15,25,23777,601056,624833,0.001610,0.026720,0.028330
10,15,25,13601,1951094,1964695,0.001145,0.076215,0.077360
11,14,25,97419,227878,325297,0.006879,0.008901,0.015780
10,15,25,7132,257094,264226,0.000613,0.010437,0.011050
9,15,24,3090,514313,517403,0.000249,0.020265,0.020514
10,14,24,17680,170036,187716,0.001395,0.006474,0.007869
8,14,22,629,1063829,1064458,0.000053,0.035241,0.035294
10,14,24,9265,3618553,3627818,0.000753,0.124586,0.125339
8,14,22,1125,1263457,1264582,0.000095,0.043408,0.043503
10,13,23,23113,157948,181061,0.001716,0.006315,0.008031
10,13,23,11809,69396,81205,0.000892,0.003216,0.004108
10,15,25,17634,5522833,5540467,0.001292,0.195402,0.196694
10,15,25,26019,1055614,1081633,0.001997,0.043871,0.045868
10,15,25,18750,680632,699382,0.001376,0.026613,0.027989
10,14,24,64000,104801,168801,0.004351,0.004882,0.009233
9,14,23,3036,92504,95540,0.000228,0.004567,0.004795
9,13,22,1446,76774,78220,0.000164,0.003472,0.003636
10,14,24,41894,72063,113957,0.002651,0.003675,0.006326
9,14,23,4295,772660,776955,0.000365,0.029409,0.029774
8,15,23,2842,173314,176156,0.000289,0.007851,0.008140
10,14,24,44884,624687,669571,0.003415,0.025139,0.028554
10,13,23,34161,119444,153605,0.002448,0.004920,0.007368
10,14,24,15468,783131,798599,0.001233,0.030922,0.032155
10,14,24,30605,73720,104325,0.002107,0.003317,0.005424
10,14,24,35503,146183,181686,0.002486,0.006171,0.008657
10,15,25,13075,811800,824875,0.000983,0.030477,0.031460
9,12,21,15357,39744,55101,0.001214,0.001809,0.003023
9,14,23,2197,418886,421083,0.000224,0.015630,0.015854
10,14,24,22562,693807,716369,0.001842,0.025534,0.027376
9,13,22,9896,41314,51210,0.000860,0.001905,0.002765
9,15,24,2103,1619097,1621200,0.000188,0.055713,0.055901
10,14,24,6964,12776,19740,0.000629,0.000919,0.001548
10,14,24,14285,1448620,1462905,0.001183,0.054020,0.055203
10,15,25,20023,1878002,1898025,0.001574,0.070764,0.072338
9,14,23,1694,171326,173020,0.000200,0.006456,0.006656
10,15,25,12190,423442,435632,0.000983,0.019204,0.020187
10,15,25,70911,987449,1058360,0.004417,0.044599,0.049016
10,12,22,31671,12890,44561,0.002332,0.000871,0.003203
7,14,21,577,214380,214957,0.000057,0.008570,0.008627
9,14,23,7161,1941795,1948956,0.000553,0.067090,0.067643
10,15,25,37225,802453,839678,0.002762,0.030331,0.033093
10,15,25,77768,1059454,1137222,0.005071,0.042653,0.047724
10,14,24,16747,559584,576331,0.001415,0.025661,0.027076
10,14,24,26505,101743,128248,0.002057,0.004115,0.006172
9,11,20,3695,4701,8396,0.000316,0.000304,0.000620
9,14,23,1863,9551220,9553083,0.000171,0.305709,0.305880
10,11,21,20659,1671,22330,0.001439,0.000114,0.001553
10,15,25,35782,461245,497027,0.002662,0.018174,0.020836
9,14,23,4098,139017,143115,0.000389,0.005845,0.006234
8,14,22,2599,1349393,1351992,0.000220,0.046585,0.046805
10,15,25,18386,900145,918531,0.001450,0.033499,0.034949
9,12,21,3441,14835,18276,0.000331,0.000774,0.001105
10,13,23,89310,20755,110065,0.005904,0.000982,0.006886
11,15,26,91145,4216145,4307290,0.005165,0.154210,0.159375
10,14,24,7447,135322,142769,0.000646,0.005812,0.006458
9,15,24,1138,1986632,1987770,0.000108,0.075631,0.075739
10,14,24,54616,1704891,1759507,0.003843,0.063585,0.067428
9,14,23,6564,675036,681600,0.000581,0.027670,0.028251
10,13,23,11392,12256,23648,0.000912,0.000653,0.001565
9,14,23,16221,13173,29394,0.001194,0.000982,0.002176
10,13,23,29423,74086,103509,0.002168,0.004240,0.006408
10,14,24,24479,99962,124441,0.001810,0.004746,0.006556
9,13,22,5216,111399,116615,0.000417,0.004453,0.004870
10,14,24,8607,329810,338417,0.000740,0.013729,0.014469
9,13,22,8469,19703,28172,0.000682,0.001091,0.001773
10,16,26,39792,3553006,3592798,0.002838,0.135272,0.138110
10,12,22,72277,36065,108342,0.004446,0.001829,0.006275
9,16,25,7262,4587825,4595087,0.000518,0.163971,0.164489
10,14,24,30851,184609,215460,0.002203,0.007533,0.009736
10,14,24,43187,1864970,1908157,0.003287,0.060168,0.063455
10,12,22,11907,2449,14356,0.000977,0.000205,0.001182
8,15,23,637,948585,949222,0.000068,0.041446,0.041514
9,14,23,2041,977218,979259,0.000201,0.035351,0.035552
10,13,23,17102,147379,164481,0.001390,0.005573,0.006963
10,15,25,24137,896689,920826,0.001799,0.032757,0.034556
9,12,21,3091,105027,108118,0.000325,0.004359,0.004684
10,15,25,8960,796243,805203,0.000707,0.029110,0.029817
10,14,24,44542,355402,399944,0.002672,0.014130,0.016802
9,15,24,12979,466410,479389,0.001028,0.018198,0.019226
11,14,25,92860,1301422,1394282,0.006016,0.044293,0.050309
9,13,22,828,213800,214628,0.000133,0.008768,0.008901
10,14,24,16097,107969,124066,0.001267,0.005748,0.007015
8,14,22,1756,1805692,1807448,0.000166,0.062340,0.062506
10,13,23,39927,279837,319764,0.003037,0.010819,0.013856
8,16,24,248,2308890,2309138,0.000023,0.088946,0.088969
10,15,25,42105,689288,731393,0.003181,0.028538,0.031719
10,15,25,20815,571145,591960,0.001594,0.021036,0.022630
9,14,23,3388,296091,299479,0.000325,0.011526,0.011851
9,14,23,3913,328832,332745,0.000375,0.013157,0.013532
10,15,25,13103,3437408,3450511,0.001015,0.135383,0.136398
10,14,24,14807,197330,212137,0.001182,0.007785,0.008967
9,16,25,9525,1877298,1886823,0.000781,0.076107,0.076888
9,15,24,9667,1086174,1095841,0.000826,0.041528,0.042354
7,15,22,206,682210,682416,0.000018,0.030721,0.030739
9,15,24,2604,516742,519346,0.000264,0.022397,0.022661
9,15,24,1587,1848936,1850523,0.000179,0.068490,0.068669
10,15,25,15304,1953322,1968626,0.001189,0.074919,0.076108
10,14,24,16910,392574,409484,0.001368,0.015952,0.017320
10,15,25,10163,1524947,1535110,0.000826,0.054843,0.055669
10,15,25,47360,1019046,1066406,0.003387,0.041291,0.044678
10,15,25,33571,10981683,11015254,0.002486,0.344136,0.346622
10,15,25,19162,213554,232716,0.001536,0.008858,0.010394
10,15,25,16306,1242725,1259031,0.001221,0.049694,0.050915
9,14,23,6125,100096,106221,0.000584,0.004294,0.004878
10,16,26,21677,3925590,3947267,0.001773,0.157283,0.159056
10,14,24,18269,223549,241818,0.001291,0.008953,0.010244
9,13,22,22471,1085,23556,0.001534,0.000096,0.001630
11,13,24,72600,5174,77774,0.004570,0.000285,0.004855
10,14,24,30123,652942,683065,0.002029,0.024210,0.026239
9,15,24,18495,134803,153298,0.001264,0.005566,0.006830
8,11,19,1524,9193,10717,0.000115,0.000421,0.000536
10,14,24,25737,168500,194237,0.001870,0.006662,0.008532
9,14,23,853,7533795,7534648,0.000090,0.260019,0.260109
9,15,24,10118,2796634,2806752,0.000845,0.102113,0.102958
8,14,22,545,223262,223807,0.000072,0.009137,0.009209
10,10,20,12990,966,13956,0.000984,0.000058,0.001042
10,13,23,20019,158400,178419,0.001372,0.006616,0.007988
10,15,25,37194,4778112,4815306,0.002758,0.177224,0.179982
10,14,24,16428,64976,81404,0.001358,0.002903,0.004261
10,15,25,20077,939665,959742,0.001456,0.042009,0.043465
9,14,23,5750,275675,281425,0.000568,0.012841,0.013409
10,14,24,25060,80962,106022,0.001783,0.003804,0.005587
10,16,26,16087,3393033,3409120,0.001305,0.128859,0.130164
9,14,23,12884,90784,103668,0.001007,0.004220,0.005227
11,13,24,79508,315210,394718,0.005404,0.012735,0.018139
8,14,22,398,199577,199975,0.000047,0.008209,0.008256
10,14,24,44896,880706,925602,0.003188,0.031788,0.034976
10,13,23,47671,193933,241604,0.003386,0.007695,0.011081
9,13,22,4411,384664,389075,0.000406,0.014253,0.014659
10,12,22,25887,79389,105276,0.001873,0.003742,0.005615
9,15,24,808,2610282,2611090,0.000100,0.100200,0.100300
9,13,22,10279,19788,30067,0.000897,0.000797,0.001694
9,15,24,1851,1140827,1142678,0.000173,0.041290,0.041463
10,14,24,61703,655779,717482,0.004000,0.025483,0.029483
10,13,23,15142,224989,240131,0.001223,0.009441,0.010664
10,15,25,45164,6128754,6173918,0.003113,0.240704,0.243817
10,15,25,15957,1698047,1714004,0.001186,0.065117,0.066303
9,12,21,889,26288,27177,0.000126,0.001159,0.001285
9,15,24,18460,429654,448114,0.001267,0.018509,0.019776
10,12,22,55255,3231,58486,0.003781,0.000192,0.003973
10,14,24,3961,281967,285928,0.000326,0.010982,0.011308
10,12,22,19060,782,19842,0.001405,0.000067,0.001472
9,15,24,2397,328934,331331,0.000222,0.014022,0.014244
9,14,23,6112,488856,494968,0.000530,0.018731,0.019261
9,13,22,20070,22881,42951,0.001351,0.001236,0.002587
10,16,26,14976,5530864,5545840,0.001105,0.249153,0.250258
11,15,26,94190,895792,989982,0.006282,0.032869,0.039151
10,15,25,20300,782039,802339,0.001578,0.030474,0.032052
8,15,23,1400,609968,611368,0.000162,0.027513,0.027675
9,14,23,9870,470588,480458,0.000795,0.020356,0.021151
10,13,23,13428,51263,64691,0.001112,0.002592,0.003704
10,16,26,18885,1822931,1841816,0.001459,0.085450,0.086909
9,14,23,1153,1180580,1181733,0.000113,0.048150,0.048263
9,13,22,6572,96580,103152,0.000546,0.004533,0.005079
10,13,23,28829,167979,196808,0.002234,0.006897,0.009131
10,12,22,24771,31533,56304,0.002007,0.001723,0.003730
9,15,24,3421,1200810,1204231,0.000263,0.053230,0.053493
9,14,23,973,206400,207373,0.000131,0.008465,0.008596
10,14,24,7884,2779555,2787439,0.000664,0.098405,0.099069
9,15,24,10780,589390,600170,0.000863,0.024189,0.025052
9,14,23,10662,441057,451719,0.000679,0.017658,0.018337
10,14,24,5189,969815,975004,0.000497,0.036759,0.037256
9,15,24,879,378932,379811,0.000123,0.015143,0.015266
9,15,24,8300,7999000,8007300,0.000596,0.299772,0.300368
9,13,22,2002,89887,91889,0.000226,0.003854,0.004080
9,12,21,6958,42787,49745,0.000532,0.001711,0.002243
10,14,24,22803,726658,749461,0.001862,0.027585,0.029447
10,13,23,44126,581695,625821,0.003301,0.021183,0.024484
9,14,23,4431,654096,658527,0.000393,0.031361,0.031754
10,15,25,13783,3340995,3354778,0.001229,0.159147,0.160376
10,13,23,17800,14252,32052,0.001470,0.000881,0.002351
10,14,24,37062,121568,158630,0.002788,0.005886,0.008674
9,15,24,685,649626,650311,0.000080,0.027974,0.028054
9,12,21,12409,38816,51225,0.001007,0.001774,0.002781
10,15,25,24506,636738,661244,0.001760,0.030039,0.031799
10,12,22,7957,93531,101488,0.000681,0.004105,0.004786
10,13,23,43111,267347,310458,0.003141,0.011907,0.015048
10,14,24,21775,504019,525794,0.001808,0.023030,0.024838
10,13,23,24459,6885,31344,0.001831,0.000349,0.002180
10,14,24,34120,611526,645646,0.002634,0.034016,0.036650
9,12,21,2064,2549,4613,0.000197,0.000335,0.000532
9,15,24,2446,5341513,5343959,0.000220,0.254555,0.254775
10,15,25,33036,1430644,1463680,0.002480,0.071552,0.074032
10,14,24,14836,744821,759657,0.001366,0.043999,0.045365
9,14,23,6807,596855,603662,0.000578,0.032981,0.033559
9,14,23,1207,254288,255495,0.000136,0.013284,0.013420
10,14,24,37752,14570,52322,0.002911,0.001323,0.004234
9,14,23,12151,215694,227845,0.000871,0.012661,0.013532
9,15,24,9803,239146,248949,0.000833,0.015915,0.016748
10,13,23,6598,431750,438348,0.000574,0.019076,0.019650
10,15,25,36228,1685923,1722151,0.003641,0.091557,0.095198
9,14,23,2433,4506055,4508488,0.000264,0.179463,0.179727
10,14,24,17059,504729,521788,0.001464,0.025419,0.026883
11,14,25,97700,503967,601667,0.007901,0.027672,0.035573
9,14,23,2536,335001,337537,0.000250,0.022111,0.022361
9,15,24,7876,2580054,2587930,0.000749,0.137464,0.138213
9,11,20,8428,6816,15244,0.000669,0.000534,0.001203
9,14,23,7933,1355197,1363130,0.000695,0.067134,0.067829
9,12,21,12548,10051,22599,0.001219,0.000753,0.001972
10,14,24,20095,664052,684147,0.002954,0.042069,0.045023
10,13,23,8451,154043,162494,0.000841,0.008184,0.009025
8,14,22,487,1525078,1525565,0.000050,0.091109,0.091159
10,14,24,21560,339771,361331,0.001810,0.021992,0.023802
9,13,22,6877,106158,113035,0.000581,0.005579,0.006160
10,15,25,48601,5066226,5114827,0.003899,0.257996,0.261895
9,13,22,10866,62337,73203,0.000985,0.002669,0.003654
9,14,23,4226,604343,608569,0.000369,0.032199,0.032568
8,14,22,1593,336538,338131,0.000141,0.018046,0.018187
10,13,23,11328,325354,336682,0.001124,0.016415,0.017539
11,13,24,129307,163954,293261,0.011456,0.008826,0.020282
10,15,25,11874,363657,375531,0.001306,0.027502,0.028808
10,15,25,8114,2966764,2974878,0.000822,0.170827,0.171649
10,14,24,14392,886816,901208,0.001421,0.041421,0.042842
9,13,22,9895,145310,155205,0.000848,0.006785,0.007633
9,15,24,1714,1595012,1596726,0.000176,0.094678,0.094854
10,13,23,36137,96343,132480,0.002932,0.005247,0.008179
10,14,24,13526,423519,437045,0.001021,0.027619,0.028640
9,13,22,4064,119814,123878,0.000396,0.006894,0.007290
10,15,25,35190,766932,802122,0.003731,0.045138,0.048869
9,14,23,2863,1007446,1010309,0.000265,0.057544,0.057809
9,15,24,18243,3124866,3143109,0.001437,0.164164,0.165601
10,14,24,52798,325316,378114,0.004212,0.014989,0.019201
9,14,23,5321,283611,288932,0.000495,0.014745,0.015240
10,13,23,51134,114222,165356,0.003711,0.005561,0.009272
10,14,24,20965,2147274,2168239,0.002185,0.110616,0.112801
9,13,22,3757,1920,5677,0.000372,0.000171,0.000543
10,15,25,44310,327695,372005,0.002547,0.019901,0.022448
9,16,25,2196,3083206,3085402,0.000237,0.159297,0.159534
9,13,22,1256,515618,516874,0.000154,0.022216,0.022370
8,15,23,837,980319,981156,0.000103,0.049233,0.049336
8,13,21,784,3238,4022,0.000104,0.000382,0.000486
9,14,23,2336,334937,337273,0.000228,0.014088,0.014316
9,13,22,4589,146530,151119,0.000475,0.009251,0.009726
10,14,24,15543,647540,663083,0.001273,0.031169,0.032442
8,14,22,1505,129877,131382,0.000138,0.006949,0.007087
9,15,24,6383,352370,358753,0.000529,0.019678,0.020207
9,14,23,2743,1162224,1164967,0.000266,0.055264,0.055530
9,13,22,9545,307957,317502,0.000896,0.013851,0.014747
10,15,25,38490,1602589,1641079,0.003133,0.075666,0.078799
10,12,22,23259,16716,39975,0.002620,0.000904,0.003524
10,15,25,57456,240787,298243,0.004516,0.012374,0.016890
10,9,19,31093,1197,32290,0.002393,0.000105,0.002498
10,13,23,51795,27326,79121,0.003884,0.002129,0.006013
7,15,22,158,532692,532850,0.000010,0.033469,0.033479
10,13,23,131111,442948,574059,0.011709,0.020624,0.032333
10,13,23,36626,11631,48257,0.002642,0.000735,0.003377
10,12,22,18770,24585,43355,0.001335,0.001548,0.002883
10,13,23,84151,314741,398892,0.007633,0.013529,0.021162
10,15,25,33337,372002,405339,0.002527,0.018652,0.021179
10,13,23,16658,647917,664575,0.001411,0.026262,0.027673
10,15,25,11114,1076914,1088028,0.000967,0.047714,0.048681
9,14,23,6904,103633,110537,0.000712,0.004778,0.005490
10,13,23,14481,58415,72896,0.001219,0.002629,0.003848
9,14,23,4421,12938,17359,0.000356,0.000989,0.001345
9,12,21,11974,240913,252887,0.000927,0.009719,0.010646
8,15,23,273,4700880,4701153,0.000026,0.208825,0.208851
9,13,22,9602,56468,66070,0.001016,0.003491,0.004507
10,13,23,28577,32376,60953,0.002445,0.001798,0.004243
10,13,23,20783,149775,170558,0.001568,0.006240,0.007808
10,13,23,43523,131055,174578,0.004157,0.006020,0.010177
11,14,25,103078,117650,220728,0.006869,0.006234,0.013103
10,14,24,26884,331322,358206,0.002132,0.015129,0.017261
9,15,24,5949,1994774,2000723,0.000524,0.089408,0.089932
10,14,24,17446,387989,405435,0.001587,0.017812,0.019399
10,13,23,41884,81268,123152,0.004437,0.004885,0.009322
9,12,21,3567,25414,28981,0.000292,0.001439,0.001731
10,13,23,35181,26425,61606,0.002617,0.001498,0.004115
10,13,23,16232,160763,176995,0.001216,0.008545,0.009761
10,13,23,19400,32475,51875,0.001594,0.001905,0.003499
10,13,23,17612,101738,119350,0.001329,0.005527,0.006856
9,13,22,3801,132796,136597,0.000309,0.004979,0.005288
10,15,25,11407,3298481,3309888,0.000880,0.131199,0.132079
10,13,23,8895,5128,14023,0.000851,0.000426,0.001277
10,14,24,19060,418800,437860,0.001347,0.017911,0.019258
9,14,23,10408,915197,925605,0.000975,0.034960,0.035935
8,14,22,740,47599,48339,0.000077,0.002137,0.002214
10,12,22,40631,1340,41971,0.002985,0.000117,0.003102
9,15,24,4300,1430881,1435181,0.000803,0.059476,0.060279
10,12,22,35694,108436,144130,0.002559,0.004173,0.006732
10,13,23,85278,301,85579,0.006390,0.000033,0.006423
10,13,23,30806,28878,59684,0.001802,0.001484,0.003286
10,16,26,10637,8416853,8427490,0.000738,0.398688,0.399426
9,13,22,5251,10606,15857,0.000485,0.000830,0.001315
10,14,24,54052,1092077,1146129,0.003507,0.041869,0.045376
10,15,25,12037,2665163,2677200,0.001040,0.104982,0.106022
10,15,25,15551,713830,729381,0.001334,0.029602,0.030936
8,13,21,2614,382205,384819,0.000178,0.016900,0.017078
10,13,23,36468,95409,131877,0.002860,0.004474,0.007334
9,14,23,5646,1409526,1415172,0.000592,0.065046,0.065638
11,14,25,156858,864538,1021396,0.012094,0.038406,0.050500
10,15,25,39141,1310277,1349418,0.004109,0.070976,0.075085
10,14,24,134416,165794,300210,0.007965,0.007453,0.015418
10,15,25,15790,2214764,2230554,0.001287,0.090249,0.091536
10,12,22,12829,140527,153356,0.001131,0.005697,0.006828
9,12,21,3891,12354,16245,0.000390,0.000802,0.001192
10,14,24,43067,174657,217724,0.002855,0.008868,0.011723
9,13,22,8488,31395,39883,0.000816,0.001685,0.002501
11,14,25,121343,3851465,3972808,0.008527,0.166200,0.174727
10,15,25,38697,1494874,1533571,0.002758,0.073282,0.076040
10,13,23,14850,110559,125409,0.001445,0.005024,0.006469
9,16,25,7062,3610650,3617712,0.000615,0.178227,0.178842
10,13,23,22937,18198,41135,0.001816,0.001013,0.002829
9,13,22,18585,286360,304945,0.001245,0.012637,0.013882
10,15,25,44241,511522,555763,0.003091,0.023401,0.026492
9,11,20,10883,11307,22190,0.000819,0.000551,0.001370
10,15,25,61296,337645,398941,0.004611,0.015114,0.019725
8,13,21,3768,74098,77866,0.000354,0.002860,0.003214
9,15,24,2637,213582,216219,0.000252,0.009407,0.009659
9,15,24,14992,2379775,2394767,0.001599,0.100276,0.101875
10,12,22,13229,7242,20471,0.001170,0.000417,0.001587
9,16,25,1800,5383076,5384876,0.000183,0.248222,0.248405
9,14,23,2212,190310,192522,0.000205,0.007674,0.007879
8,15,23,496,2563669,2564165,0.000049,0.107329,0.107378
10,14,24,10144,420988,431132,0.000777,0.018167,0.018944
9,16,25,7188,7585647,7592835,0.000572,0.321043,0.321615
9,15,24,6123,433510,439633,0.000511,0.017791,0.018302
9,14,23,3364,599143,602507,0.000352,0.023317,0.023669
9,15,24,8745,1674082,1682827,0.000692,0.063717,0.064409
10,13,23,17975,23967,41942,0.001305,0.001335,0.002640
10,13,23,35758,46397,82155,0.002299,0.002023,0.004322
10,14,24,51175,4738818,4789993,0.003875,0.178353,0.182228
9,14,23,4705,245095,249800,0.000413,0.008858,0.009271
10,14,24,29344,209830,239174,0.001997,0.008053,0.010050
8,15,23,888,3341016,3341904,0.000072,0.122406,0.122478
10,14,24,77427,254859,332286,0.005011,0.009282,0.014293
9,13,22,7480,25795,33275,0.000598,0.001356,0.001954
10,15,25,53471,672636,726107,0.003810,0.026994,0.030804
10,14,24,14470,1177494,1191964,0.001028,0.039695,0.040723
10,15,25,63587,430106,493693,0.004031,0.017007,0.021038
9,12,21,10404,21684,32088,0.000799,0.000986,0.001785
9,12,21,4306,41241,45547,0.000403,0.001918,0.002321
10,16,26,77063,3845086,3922149,0.005272,0.153219,0.158491
9,11,20,9396,26421,35817,0.000722,0.001037,0.001759
8,15,23,796,1157460,1158256,0.000059,0.042475,0.042534
10,14,24,9916,269044,278960,0.000797,0.010595,0.011392
9,15,24,7886,4739466,4747352,0.000627,0.174099,0.174726
9,15,24,741,1080527,1081268,0.000076,0.043451,0.043527
9,15,24,8176,1113412,1121588,0.000684,0.042544,0.043228
8,14,22,1658,599254,600912,0.000153,0.021806,0.021959
8,13,21,1731,434967,436698,0.000153,0.015875,0.016028
10,15,25,16227,364854,381081,0.001301,0.013211,0.014512
8,13,21,3342,114765,118107,0.000256,0.004758,0.005014
9,13,22,10628,75706,86334,0.000848,0.003043,0.003891
10,15,25,35162,1871288,1906450,0.002816,0.074471,0.077287
9,13,22,6410,78411,84821,0.000530,0.003106,0.003636
10,14,24,45919,1414920,1460839,0.003309,0.050726,0.054035
10,16,26,5056,2875155,2880211,0.000405,0.109491,0.109896
8,13,21,392,62428,62820,0.000039,0.002757,0.002796
10,16,26,12003,3098826,3110829,0.000929,0.129500,0.130429
10,13,23,16254,695,16949,0.001294,0.000069,0.001363
9,16,25,10752,1745904,1756656,0.000750,0.070542,0.071292
9,13,22,2628,197483,200111,0.000209,0.007421,0.007630
10,15,25,8452,2663319,2671771,0.000652,0.097239,0.097891
9,15,24,1981,1297368,1299349,0.000180,0.049324,0.049504
10,12,22,23487,16758,40245,0.001736,0.000715,0.002451
10,14,24,31816,493535,525351,0.002225,0.018700,0.020925
10,14,24,15546,864630,880176,0.001278,0.031041,0.032319
9,15,24,16244,3463433,3479677,0.001171,0.135111,0.136282
10,15,25,9162,415483,424645,0.000723,0.015698,0.016421
9,14,23,7885,213738,221623,0.000616,0.008714,0.009330
9,14,23,3842,1311969,1315811,0.000327,0.048125,0.048452
8,14,22,1136,1904046,1905182,0.000100,0.075365,0.075465
9,15,24,5202,761543,766745,0.000450,0.029778,0.030228
9,12,21,8319,68096,76415,0.000683,0.002661,0.003344
9,14,23,2260,170438,172698,0.000271,0.007028,0.007299
10,14,24,7993,699660,707653,0.000658,0.030984,0.031642
10,14,24,7862,516781,524643,0.000669,0.020917,0.021586
9,15,24,1660,3007888,3009548,0.000158,0.115210,0.115368
9,14,23,29222,352836,382058,0.002007,0.013666,0.015673
9,14,23,7050,167783,174833,0.000566,0.006630,0.007196
10,13,23,12653,214262,226915,0.001001,0.008408,0.009409
9,14,23,3396,221348,224744,0.000269,0.008571,0.008840
10,13,23,24232,4738,28970,0.001837,0.000263,0.002100
8,15,23,689,251287,251976,0.000051,0.009872,0.009923
10,16,26,73608,1402345,1475953,0.004431,0.056314,0.060745
10,15,25,23365,1547221,1570586,0.001775,0.053632,0.055407
10,14,24,13045,248189,261234,0.001011,0.010396,0.011407
10,15,25,6856,2293550,2300406,0.000608,0.092805,0.093413
9,14,23,2390,4065203,4067593,0.000211,0.167480,0.167691
9,14,23,6678,1236153,1242831,0.000514,0.050268,0.050782
10,14,24,15626,620300,635926,0.001691,0.023747,0.025438
9,13,22,6098,216276,222374,0.000492,0.009148,0.009640
10,13,23,23228,14789,38017,0.002045,0.001203,0.003248
8,14,22,4321,169438,173759,0.000346,0.007142,0.007488
10,15,25,45605,5627540,5673145,0.003046,0.235626,0.238672
9,15,24,6864,151700,158564,0.000596,0.007235,0.007831
10,14,24,49831,53697,103528,0.003388,0.002968,0.006356
10,13,23,13345,13507,26852,0.000946,0.000709,0.001655
9,15,24,5591,2415061,2420652,0.000458,0.106439,0.106897
9,14,23,9137,1322872,1332009,0.000680,0.046345,0.047025
10,15,25,20889,332221,353110,0.001489,0.013436,0.014925
10,15,25,14133,2260245,2274378,0.001248,0.083382,0.084630
10,13,23,7977,239703,247680,0.000628,0.009298,0.009926
9,14,23,9824,195949,205773,0.000677,0.007591,0.008268
10,13,23,52408,87247,139655,0.003603,0.004078,0.007681
10,14,24,41909,1657120,1699029,0.002894,0.060198,0.063092
9,13,22,8663,25291,33954,0.000680,0.001186,0.001866
9,14,23,2518,567940,570458,0.000195,0.022142,0.022337
10,13,23,107126,239713,346839,0.007050,0.009572,0.016622
9,15,24,1000,271844,272844,0.000084,0.011457,0.011541
10,14,24,36396,2230143,2266539,0.002559,0.106548,0.109107
10,15,25,23777,601056,624833,0.001619,0.027810,0.029429
10,15,25,13601,1951094,1964695,0.001064,0.073759,0.074823
11,14,25,97419,227878,325297,0.006459,0.009115,0.015574
10,15,25,7132,257094,264226,0.000561,0.009830,0.010391
9,15,24,3090,514313,517403,0.000240,0.020600,0.020840
10,14,24,17680,170036,187716,0.001404,0.006600,0.008004
8,14,22,629,1063829,1064458,0.000053,0.036200,0.036253
10,14,24,9265,3618553,3627818,0.000748,0.129435,0.130183
8,14,22,1125,1263457,1264582,0.000093,0.044733,0.044826
10,13,23,23113,157948,181061,0.001831,0.006429,0.008260
10,13,23,11809,69396,81205,0.000875,0.003977,0.004852
10,15,25,17634,5522833,5540467,0.001273,0.206463,0.207736
10,15,25,26019,1055614,1081633,0.002133,0.048011,0.050144
10,15,25,18750,680632,699382,0.001501,0.027630,0.029131
10,14,24,64000,104801,168801,0.004420,0.005049,0.009469
9,14,23,3036,92504,95540,0.000221,0.005330,0.005551
9,13,22,1446,76774,78220,0.000155,0.003442,0.003597
10,14,24,41894,72063,113957,0.002707,0.003704,0.006411
9,14,23,4295,772660,776955,0.000379,0.031522,0.031901
8,15,23,2842,173314,176156,0.000264,0.008954,0.009218
10,14,24,44884,624687,669571,0.003344,0.026129,0.029473
10,13,23,34161,119444,153605,0.002666,0.004929,0.007595
10,14,24,15468,783131,798599,0.001224,0.034186,0.035410
10,14,24,30605,73720,104325,0.002194,0.003382,0.005576
10,14,24,35503,146183,181686,0.003250,0.006272,0.009522
10,15,25,13075,811800,824875,0.001148,0.032941,0.034089
9,12,21,15357,39744,55101,0.001301,0.001835,0.003136
9,14,23,2197,418886,421083,0.000209,0.016708,0.016917
10,14,24,22562,693807,716369,0.001814,0.027392,0.029206
9,13,22,9896,41314,51210,0.000947,0.001898,0.002845
9,15,24,2103,1619097,1621200,0.000181,0.059510,0.059691
10,14,24,6964,12776,19740,0.000593,0.001127,0.001720
10,14,24,14285,1448620,1462905,0.001101,0.057170,0.058271
10,15,25,20023,1878002,1898025,0.001659,0.073869,0.075528
9,14,23,1694,171326,173020,0.000163,0.006656,0.006819
10,15,25,12190,423442,435632,0.000901,0.017816,0.018717
10,15,25,70911,987449,1058360,0.005162,0.042480,0.047642
10,12,22,31671,12890,44561,0.002484,0.001343,0.003827
7,14,21,577,214380,214957,0.000041,0.008715,0.008756
9,14,23,7161,1941795,1948956,0.000635,0.068649,0.069284
10,15,25,37225,802453,839678,0.002783,0.031357,0.034140
10,15,25,77768,1059454,1137222,0.005476,0.045677,0.051153
10,14,24,16747,559584,576331,0.001474,0.028681,0.030155
10,14,24,26505,101743,128248,0.002150,0.004560,0.006710
9,11,20,3695,4701,8396,0.000313,0.000371,0.000684
9,14,23,1863,9551220,9553083,0.000180,0.318251,0.318431
10,11,21,20659,1671,22330,0.001429,0.000118,0.001547
10,15,25,35782,461245,497027,0.002652,0.019223,0.021875
9,14,23,4098,139017,143115,0.000374,0.005711,0.006085
8,14,22,2599,1349393,1351992,0.000227,0.047447,0.047674
10,15,25,18386,900145,918531,0.001505,0.035566,0.037071
9,12,21,3441,14835,18276,0.000329,0.000879,0.001208
10,13,23,89310,20755,110065,0.005940,0.001197,0.007137
11,15,26,91145,4216145,4307290,0.005206,0.161599,0.166805
10,14,24,7447,135322,142769,0.000652,0.005761,0.006413
9,15,24,1138,1986632,1987770,0.000102,0.079204,0.079306
10,14,24,54616,1704891,1759507,0.003930,0.066432,0.070362
9,14,23,6564,675036,681600,0.000572,0.024982,0.025554
10,13,23,11392,12256,23648,0.001032,0.000625,0.001657
9,14,23,16221,13173,29394,0.001155,0.000984,0.002139
10,13,23,29423,74086,103509,0.002037,0.003557,0.005594
10,14,24,24479,99962,124441,0.002236,0.004900,0.007136
9,13,22,5216,111399,116615,0.000408,0.004555,0.004963
10,14,24,8607,329810,338417,0.000700,0.014213,0.014913
9,13,22,8469,19703,28172,0.000737,0.001221,0.001958
10,16,26,39792,3553006,3592798,0.002758,0.142859,0.145617
10,12,22,72277,36065,108342,0.004533,0.001822,0.006355
9,16,25,7262,4587825,4595087,0.000520,0.170819,0.171339
10,14,24,30851,184609,215460,0.002419,0.007608,0.010027
10,14,24,43187,1864970,1908157,0.003358,0.068095,0.071453
10,12,22,11907,2449,14356,0.001115,0.000605,0.001720
8,15,23,637,948585,949222,0.000050,0.043141,0.043191
9,14,23,2041,977218,979259,0.000182,0.036374,0.036556
10,13,23,17102,147379,164481,0.001429,0.006082,0.007511
10,15,25,24137,896689,920826,0.001838,0.034532,0.036370
9,12,21,3091,105027,108118,0.000297,0.004323,0.004620
10,15,25,8960,796243,805203,0.000738,0.030513,0.031251
10,14,24,44542,355402,399944,0.002669,0.015172,0.017841
9,15,24,12979,466410,479389,0.001092,0.019150,0.020242
11,14,25,92860,1301422,1394282,0.006678,0.045984,0.052662
9,13,22,828,213800,214628,0.000119,0.009016,0.009135
10,14,24,16097,107969,124066,0.001233,0.005673,0.006906
8,14,22,1756,1805692,1807448,0.000211,0.066897,0.067108
10,13,23,39927,279837,319764,0.003229,0.010965,0.014194
8,16,24,248,2308890,2309138,0.000022,0.093111,0.093133
10,15,25,42105,689288,731393,0.003117,0.029843,0.032960
10,15,25,20815,571145,591960,0.001748,0.021860,0.023608
9,14,23,3388,296091,299479,0.000319,0.012630,0.012949
9,14,23,3913,328832,332745,0.000377,0.013937,0.014314
10,15,25,13103,3437408,3450511,0.001147,0.131476,0.132623
10,14,24,14807,197330,212137,0.001281,0.007601,0.008882
9,16,25,9525,1877298,1886823,0.001329,0.077619,0.078948
9,15,24,9667,1086174,1095841,0.000953,0.042649,0.043602
7,15,22,206,682210,682416,0.000019,0.032303,0.032322
9,15,24,2604,516742,519346,0.000276,0.023328,0.023604
9,15,24,1587,1848936,1850523,0.000184,0.070620,0.070804
10,15,25,15304,1953322,1968626,0.001314,0.082731,0.084045
10,14,24,16910,392574,409484,0.001529,0.015500,0.017029
10,15,25,10163,1524947,1535110,0.001424,0.057233,0.058657
10,15,25,47360,1019046,1066406,0.003401,0.042411,0.045812
10,15,25,33571,10981683,11015254,0.002560,0.355519,0.358079
10,15,25,19162,213554,232716,0.001637,0.009713,0.011350
10,15,25,16306,1242725,1259031,0.001350,0.051744,0.053094
9,14,23,6125,100096,106221,0.000576,0.004311,0.004887
10,16,26,21677,3925590,3947267,0.001795,0.156861,0.158656
10,14,24,18269,223549,241818,0.001408,0.008932,0.010340
9,13,22,22471,1085,23556,0.002247,0.000133,0.002380
11,13,24,72600,5174,77774,0.004657,0.000283,0.004940
10,14,24,30123,652942,683065,0.001954,0.025833,0.027787
9,15,24,18495,134803,153298,0.001396,0.005820,0.007216
8,11,19,1524,9193,10717,0.000126,0.000420,0.000546
10,14,24,25737,168500,194237,0.001837,0.007082,0.008919
9,14,23,853,7533795,7534648,0.000079,0.278631,0.278710
9,15,24,10118,2796634,2806752,0.000966,0.105343,0.106309
8,14,22,545,223262,223807,0.000056,0.009419,0.009475
10,10,20,12990,966,13956,0.001044,0.000060,0.001104
10,13,23,20019,158400,178419,0.001377,0.007176,0.008553
10,15,25,37194,4778112,4815306,0.002723,0.184913,0.187636
10,14,24,16428,64976,81404,0.001372,0.002912,0.004284
10,15,25,20077,939665,959742,0.001447,0.044544,0.045991
9,14,23,5750,275675,281425,0.000509,0.013679,0.014188
10,14,24,25060,80962,106022,0.001845,0.003825,0.005670
10,16,26,16087,3393033,3409120,0.001316,0.133759,0.135075
9,14,23,12884,90784,103668,0.001076,0.004709,0.005785
11,13,24,79508,315210,394718,0.005265,0.013296,0.018561
8,14,22,398,199577,199975,0.000038,0.008257,0.008295
10,14,24,44896,880706,925602,0.003203,0.033339,0.036542
10,13,23,47671,193933,241604,0.003510,0.007980,0.011490
9,13,22,4411,384664,389075,0.000387,0.015370,0.015757
10,12,22,25887,79389,105276,0.001902,0.003237,0.005139
9,15,24,808,2610282,2611090,0.000084,0.097026,0.097110
9,13,22,10279,19788,30067,0.001059,0.000858,0.001917
9,15,24,1851,1140827,1142678,0.000166,0.043211,0.043377
10,14,24,61703,655779,717482,0.004063,0.026210,0.030273
10,13,23,15142,224989,240131,0.001211,0.008857,0.010068
10,15,25,45164,6128754,6173918,0.003862,0.231421,0.235283
10,15,25,15957,1698047,1714004,0.001415,0.066884,0.068299
9,12,21,889,26288,27177,0.000104,0.001324,0.001428
9,15,24,18460,429654,448114,0.001266,0.019311,0.020577
10,12,22,55255,3231,58486,0.003817,0.000199,0.004016
10,14,24,3961,281967,285928,0.000328,0.011931,0.012259
10,12,22,19060,782,19842,0.001488,0.000071,0.001559
9,15,24,2397,328934,331331,0.000215,0.014676,0.014891
9,14,23,6112,488856,494968,0.000597,0.018167,0.018764
9,13,22,20070,22881,42951,0.001378,0.001197,0.002575
10,16,26,14976,5530864,5545840,0.001080,0.225969,0.227049
11,15,26,94190,895792,989982,0.006212,0.035189,0.041401
10,15,25,20300,782039,802339,0.001657,0.031293,0.032950
8,15,23,1400,609968,611368,0.000156,0.027300,0.027456
9,14,23,9870,470588,480458,0.000923,0.018994,0.019917
10,13,23,13428,51263,64691,0.001170,0.002431,0.003601
10,16,26,18885,1822931,1841816,0.001437,0.076333,0.077770
9,14,23,1153,1180580,1181733,0.000137,0.045347,0.045484
9,13,22,6572,96580,103152,0.000598,0.004365,0.004963
10,13,23,28829,167979,196808,0.002275,0.007192,0.009467
10,12,22,24771,31533,56304,0.002560,0.001623,0.004183
9,15,24,3421,1200810,1204231,0.000246,0.048237,0.048483
9,14,23,973,206400,207373,0.000130,0.008783,0.008913
10,14,24,7884,2779555,2787439,0.000630,0.100549,0.101179
9,15,24,10780,589390,600170,0.000958,0.025672,0.026630
9,14,23,10662,441057,451719,0.000761,0.021079,0.021840
10,14,24,5189,969815,975004,0.000476,0.042621,0.043097
9,15,24,879,378932,379811,0.000090,0.016222,0.016312
9,15,24,8300,7999000,8007300,0.000572,0.297223,0.297795
9,13,22,2002,89887,91889,0.000225,0.004478,0.004703
9,12,21,6958,42787,49745,0.000534,0.001780,0.002314
10,14,24,22803,726658,749461,0.001720,0.034094,0.035814
10,13,23,44126,581695,625821,0.003312,0.025850,0.029162
9,14,23,4431,654096,658527,0.000388,0.028392,0.028780
10,15,25,13783,3340995,3354778,0.001213,0.152851,0.154064
10,13,23,17800,14252,32052,0.001599,0.000961,0.002560
10,14,24,37062,121568,158630,0.002531,0.005193,0.007724
9,15,24,685,649626,650311,0.000084,0.030862,0.030946
9,12,21,12409,38816,51225,0.001109,0.001618,0.002727
10,15,25,24506,636738,661244,0.002704,0.030195,0.032899
10,12,22,7957,93531,101488,0.000680,0.005501,0.006181
10,13,23,43111,267347,310458,0.003132,0.010448,0.013580
10,14,24,21775,504019,525794,0.001660,0.018897,0.020557
10,13,23,24459,6885,31344,0.001893,0.000316,0.002209
10,14,24,34120,611526,645646,0.002263,0.026529,0.028792
9,12,21,2064,2549,4613,0.000189,0.000230,0.000419
9,15,24,2446,5341513,5343959,0.000308,0.187444,0.187752
10,15,25,33036,1430644,1463680,0.002699,0.060184,0.062883
10,14,24,14836,744821,759657,0.001367,0.029967,0.031334
9,14,23,6807,596855,603662,0.000536,0.022860,0.023396
9,14,23,1207,254288,255495,0.000153,0.011344,0.011497
10,14,24,37752,14570,52322,0.002699,0.001249,0.003948
9,14,23,12151,215694,227845,0.000837,0.009951,0.010788
9,15,24,9803,239146,248949,0.000782,0.011545,0.012327
10,13,23,6598,431750,438348,0.000562,0.014926,0.015488
10,15,25,36228,1685923,1722151,0.002642,0.071816,0.074458
9,14,23,2433,4506055,4508488,0.000259,0.144167,0.144426
10,14,24,17059,504729,521788,0.001452,0.019597,0.021049
11,14,25,97700,503967,601667,0.006551,0.021629,0.028180
9,14,23,2536,335001,337537,0.000240,0.014706,0.014946
9,15,24,7876,2580054,2587930,0.000797,0.095148,0.095945
9,11,20,8428,6816,15244,0.000781,0.000414,0.001195
9,14,23,7933,1355197,1363130,0.000635,0.050723,0.051358
9,12,21,12548,10051,22599,0.001056,0.000518,0.001574
10,14,24,20095,664052,684147,0.001562,0.028462,0.030024
10,13,23,8451,154043,162494,0.000844,0.005922,0.006766
8,14,22,487,1525078,1525565,0.000056,0.057885,0.057941
10,14,24,21560,339771,361331,0.001716,0.014165,0.015881
9,13,22,6877,106158,113035,0.000566,0.004368,0.004934
10,15,25,48601,5066226,5114827,0.003296,0.189249,0.192545
9,13,22,10866,62337,73203,0.001055,0.002909,0.003964
9,14,23,4226,604343,608569,0.000376,0.029165,0.029541
8,14,22,1593,336538,338131,0.000141,0.016938,0.017079
10,13,23,11328,325354,336682,0.001020,0.011777,0.012797
11,13,24,129307,163954,293261,0.010682,0.007283,0.017965
10,15,25,11874,363657,375531,0.001457,0.021225,0.022682
10,15,25,8114,2966764,2974878,0.000679,0.134686,0.135365
10,14,24,14392,886816,901208,0.001311,0.031667,0.032978
9,13,22,9895,145310,155205,0.000728,0.006599,0.007327
9,15,24,1714,1595012,1596726,0.000178,0.064620,0.064798
10,13,23,36137,96343,132480,0.003222,0.004857,0.008079
10,14,24,13526,423519,437045,0.001125,0.017552,0.018677
9,13,22,4064,119814,123878,0.000436,0.004982,0.005418
10,15,25,35190,766932,802122,0.002723,0.029894,0.032617
9,14,23,2863,1007446,1010309,0.000253,0.037948,0.038201
9,15,24,18243,3124866,3143109,0.001538,0.133715,0.135253
10,14,24,52798,325316,378114,0.004426,0.014754,0.019180
9,14,23,5321,283611,288932,0.000485,0.012812,0.013297
10,13,23,51134,114222,165356,0.004928,0.005342,0.010270
10,14,24,20965,2147274,2168239,0.001475,0.087830,0.089305
9,13,22,3757,1920,5677,0.000389,0.000176,0.000565
10,15,25,44310,327695,372005,0.002452,0.016447,0.018899
9,16,25,2196,3083206,3085402,0.000210,0.123712,0.123922
9,13,22,1256,515618,516874,0.000156,0.019647,0.019803
8,15,23,837,980319,981156,0.000102,0.040676,0.040778
8,13,21,784,3238,4022,0.000114,0.000238,0.000352
9,14,23,2336,334937,337273,0.000232,0.012118,0.012350
9,13,22,4589,146530,151119,0.000938,0.006339,0.007277
10,14,24,15543,647540,663083,0.001256,0.026406,0.027662
8,14,22,1505,129877,131382,0.000140,0.006995,0.007135
9,15,24,6383,352370,358753,0.000527,0.018221,0.018748
9,14,23,2743,1162224,1164967,0.000241,0.045763,0.046004
9,13,22,9545,307957,317502,0.000912,0.012570,0.013482
10,15,25,38490,1602589,1641079,0.003014,0.063477,0.066491
10,12,22,23259,16716,39975,0.001874,0.000814,0.002688
10,15,25,57456,240787,298243,0.003636,0.013060,0.016696
10,9,19,31093,1197,32290,0.002227,0.000087,0.002314
10,13,23,51795,27326,79121,0.003446,0.002103,0.005549
7,15,22,158,532692,532850,0.000008,0.028657,0.028665
10,13,23,131111,442948,574059,0.009090,0.016514,0.025604
10,13,23,36626,11631,48257,0.002564,0.000674,0.003238
10,12,22,18770,24585,43355,0.001377,0.001295,0.002672
10,13,23,84151,314741,398892,0.005578,0.013018,0.018596
10,15,25,33337,372002,405339,0.002233,0.017957,0.020190
10,13,23,16658,647917,664575,0.001306,0.025240,0.026546
10,15,25,11114,1076914,1088028,0.000930,0.042989,0.043919
9,14,23,6904,103633,110537,0.000693,0.004344,0.005037
10,13,23,14481,58415,72896,0.001158,0.002416,0.003574
9,14,23,4421,12938,17359,0.000337,0.000956,0.001293
9,12,21,11974,240913,252887,0.000882,0.009042,0.009924
8,15,23,273,4700880,4701153,0.000024,0.184380,0.184404
9,13,22,9602,56468,66070,0.000909,0.002503,0.003412
10,13,23,28577,32376,60953,0.002072,0.001544,0.003616
10,13,23,20783,149775,170558,0.001497,0.006801,0.008298
10,13,23,43523,131055,174578,0.002737,0.005338,0.008075
11,14,25,103078,117650,220728,0.007769,0.004686,0.012455
10,14,24,26884,331322,358206,0.001810,0.014084,0.015894
9,15,24,5949,1994774,2000723,0.000497,0.075271,0.075768
10,14,24,17446,387989,405435,0.001566,0.015257,0.016823
10,13,23,41884,81268,123152,0.003765,0.004014,0.007779
9,12,21,3567,25414,28981,0.000262,0.001340,0.001602
10,13,23,35181,26425,61606,0.002669,0.001474,0.004143
10,13,23,16232,160763,176995,0.001151,0.007607,0.008758
10,13,23,19400,32475,51875,0.001427,0.001747,0.003174
10,13,23,17612,101738,119350,0.001315,0.005063,0.006378
9,13,22,3801,132796,136597,0.000295,0.005548,0.005843
10,15,25,11407,3298481,3309888,0.000872,0.130594,0.131466
10,13,23,8895,5128,14023,0.000870,0.000402,0.001272
10,14,24,19060,418800,437860,0.001292,0.017848,0.019140
9,14,23,10408,915197,925605,0.000854,0.035206,0.036060
8,14,22,740,47599,48339,0.000098,0.002176,0.002274
10,12,22,40631,1340,41971,0.002935,0.000109,0.003044
9,15,24,4300,1430881,1435181,0.000322,0.060575,0.060897
10,12,22,35694,108436,144130,0.002540,0.004076,0.006616
10,13,23,85278,301,85579,0.006597,0.000033,0.006630
10,13,23,30806,28878,59684,0.001764,0.001395,0.003159
10,16,26,10637,8416853,8427490,0.000755,0.349188,0.349943
9,13,22,5251,10606,15857,0.000459,0.000798,0.001257
10,14,24,54052,1092077,1146129,0.003464,0.040931,0.044395
10,15,25,12037,2665163,2677200,0.001104,0.105534,0.106638
10,15,25,15551,713830,729381,0.001343,0.028962,0.030305
8,13,21,2614,382205,384819,0.000214,0.015188,0.015402
10,13,23,36468,95409,131877,0.002916,0.004569,0.007485
9,14,23,5646,1409526,1415172,0.000473,0.055148,0.055621
11,14,25,156858,864538,1021396,0.009748,0.032719,0.042467
10,15,25,39141,1310277,1349418,0.002939,0.059384,0.062323
10,14,24,134416,165794,300210,0.008034,0.007068,0.015102
10,15,25,15790,2214764,2230554,0.001273,0.083969,0.085242
10,12,22,12829,140527,153356,0.001115,0.005077,0.006192
9,12,21,3891,12354,16245,0.000309,0.000636,0.000945
10,14,24,43067,174657,217724,0.002720,0.008579,0.011299
9,13,22,8488,31395,39883,0.000679,0.001749,0.002428
11,14,25,121343,3851465,3972808,0.008252,0.154862,0.163114
10,15,25,38697,1494874,1533571,0.002803,0.063162,0.065965
10,13,23,14850,110559,125409,0.001378,0.004375,0.005753
9,16,25,7062,3610650,3617712,0.000590,0.157900,0.158490
10,13,23,22937,18198,41135,0.001758,0.001000,0.002758
9,13,22,18585,286360,304945,0.001293,0.012185,0.013478
10,15,25,44241,511522,555763,0.003163,0.024022,0.027185
9,11,20,10883,11307,22190,0.000822,0.000557,0.001379
10,15,25,61296,337645,398941,0.004483,0.014274,0.018757
8,13,21,3768,74098,77866,0.000352,0.003315,0.003667
9,15,24,2637,213582,216219,0.000238,0.009467,0.009705
9,15,24,14992,2379775,2394767,0.001060,0.096217,0.097277
10,12,22,13229,7242,20471,0.001243,0.000434,0.001677
