phase1_solution_length,phase2_solution_length,solution_length,phase1_move_count,phase2_move_count,move_count,phase1_solve_time,phase2_solve_time,solve_time
9,16,25,1800,5383076,5384876,0.000105,0.116762,0.116867
9,14,23,2212,190310,192522,0.000113,0.003444,0.003557
8,15,23,496,2563669,2564165,0.000024,0.044978,0.045002
10,14,24,10144,420988,431132,0.000570,0.007190,0.007760
9,16,25,7188,7585647,7592835,0.000313,0.126656,0.126969
9,15,24,6123,433510,439633,0.000302,0.007249,0.007551
9,14,23,3364,599143,602507,0.000160,0.010262,0.010422
9,15,24,8745,1674082,1682827,0.000386,0.027391,0.027777
10,13,23,17975,23967,41942,0.000706,0.000456,0.001162
10,13,23,35758,46397,82155,0.001424,0.000851,0.002275
10,14,24,51175,4738818,4789993,0.001681,0.084024,0.085705
9,14,23,4705,245095,249800,0.000203,0.004236,0.004439
10,14,24,29344,209830,239174,0.001103,0.003745,0.004848
8,15,23,888,3341016,3341904,0.000039,0.055986,0.056025
10,14,24,77427,254859,332286,0.002847,0.004427,0.007274
9,13,22,7480,25795,33275,0.000286,0.000585,0.000871
10,15,25,53471,672636,726107,0.001837,0.014441,0.016278
10,14,24,14470,1177494,1191964,0.000611,0.023539,0.024150
10,15,25,63587,430106,493693,0.002222,0.008721,0.010943
9,12,21,10404,21684,32088,0.000474,0.000549,0.001023
9,12,21,4306,41241,45547,0.000192,0.000956,0.001148
10,16,26,77063,3845086,3922149,0.003055,0.074380,0.077435
9,11,20,9396,26421,35817,0.000390,0.000447,0.000837
8,15,23,796,1157460,1158256,0.000032,0.019689,0.019721
10,14,24,9916,269044,278960,0.000546,0.004857,0.005403
9,15,24,7886,4739466,4747352,0.000340,0.079535,0.079875
9,15,24,741,1080527,1081268,0.000036,0.019120,0.019156
9,15,24,8176,1113412,1121588,0.000368,0.019140,0.019508
8,14,22,1658,599254,600912,0.000078,0.010041,0.010119
8,13,21,1731,434967,436698,0.000079,0.007340,0.007419
10,15,25,16227,364854,381081,0.000746,0.006041,0.006787
8,13,21,3342,114765,118107,0.000130,0.001988,0.002118
9,13,22,10628,75706,86334,0.000420,0.001323,0.001743
10,15,25,35162,1871288,1906450,0.001397,0.032706,0.034103
9,13,22,6410,78411,84821,0.000281,0.001422,0.001703
10,14,24,45919,1414920,1460839,0.001791,0.032875,0.034666
10,16,26,5056,2875155,2880211,0.000239,0.051264,0.051503
8,13,21,392,62428,62820,0.000021,0.001156,0.001177
10,16,26,12003,3098826,3110829,0.000554,0.056840,0.057394
10,13,23,16254,695,16949,0.000746,0.000026,0.000772
9,16,25,10752,1745904,1756656,0.000441,0.031519,0.031960
9,13,22,2628,197483,200111,0.000112,0.003490,0.003602
10,15,25,8452,2663319,2671771,0.000440,0.058652,0.059092
9,15,24,1981,1297368,1299349,0.000108,0.022380,0.022488
10,12,22,23487,16758,40245,0.001024,0.000317,0.001341
10,14,24,31816,493535,525351,0.001252,0.009956,0.011208
10,14,24,15546,864630,880176,0.000711,0.018550,0.019261
9,15,24,16244,3463433,3479677,0.000675,0.061052,0.061727
10,15,25,9162,415483,424645,0.000421,0.007146,0.007567
9,14,23,7885,213738,221623,0.000351,0.003830,0.004181
9,14,23,3842,1311969,1315811,0.000172,0.021848,0.022020
8,14,22,1136,1904046,1905182,0.000048,0.031605,0.031653
9,15,24,5202,761543,766745,0.000248,0.013090,0.013338
9,12,21,8319,68096,76415,0.000383,0.001129,0.001512
9,14,23,2260,170438,172698,0.000107,0.003110,0.003217
10,14,24,7993,699660,707653,0.000367,0.014578,0.014945
10,14,24,7862,516781,524643,0.000387,0.009565,0.009952
9,15,24,1660,3007888,3009548,0.000086,0.051325,0.051411
9,14,23,29222,352836,382058,0.001139,0.006240,0.007379
9,14,23,7050,167783,174833,0.000289,0.003031,0.003320
10,13,23,12653,214262,226915,0.000515,0.003853,0.004368
9,14,23,3396,221348,224744,0.000128,0.004041,0.004169
10,13,23,24232,4738,28970,0.000983,0.000111,0.001094
8,15,23,689,251287,251976,0.000027,0.004625,0.004652
10,16,26,73608,1402345,1475953,0.002517,0.031399,0.033916
10,15,25,23365,1547221,1570586,0.001087,0.028620,0.029707
10,14,24,13045,248189,261234,0.000556,0.004601,0.005157
10,15,25,6856,2293550,2300406,0.000310,0.038477,0.038787
9,14,23,2390,4065203,4067593,0.000109,0.066121,0.066230
9,14,23,6678,1236153,1242831,0.000292,0.020370,0.020662
10,14,24,15626,620300,635926,0.000673,0.010473,0.011146
9,13,22,6098,216276,222374,0.000262,0.003770,0.004032
10,13,23,23228,14789,38017,0.001000,0.000370,0.001370
8,14,22,4321,169438,173759,0.000174,0.003035,0.003209
10,15,25,45605,5627540,5673145,0.001634,0.098917,0.100551
9,15,24,6864,151700,158564,0.000334,0.002692,0.003026
10,14,24,49831,53697,103528,0.001838,0.001170,0.003008
10,13,23,13345,13507,26852,0.000496,0.000302,0.000798
9,15,24,5591,2415061,2420652,0.000218,0.044438,0.044656
9,14,23,9137,1322872,1332009,0.000384,0.021933,0.022317
10,15,25,20889,332221,353110,0.000830,0.006037,0.006867
10,15,25,14133,2260245,2274378,0.000612,0.038022,0.038634
10,13,23,7977,239703,247680,0.000348,0.004351,0.004699
9,14,23,9824,195949,205773,0.000373,0.003409,0.003782
10,13,23,52408,87247,139655,0.001963,0.001779,0.003742
10,14,24,41909,1657120,1699029,0.001519,0.039672,0.041191
9,13,22,8663,25291,33954,0.000391,0.000537,0.000928
9,14,23,2518,567940,570458,0.000114,0.011627,0.011741
10,13,23,107126,239713,346839,0.003905,0.005273,0.009178
9,15,24,1000,271844,272844,0.000042,0.006311,0.006353
10,14,24,36396,2230143,2266539,0.001550,0.045719,0.047269
10,15,25,23777,601056,624833,0.000925,0.011792,0.012717
10,15,25,13601,1951094,1964695,0.000597,0.034476,0.035073
11,14,25,97419,227878,325297,0.003699,0.004569,0.008268
10,15,25,7132,257094,264226,0.000280,0.005791,0.006071
9,15,24,3090,514313,517403,0.000134,0.012075,0.012209
10,14,24,17680,170036,187716,0.000836,0.003857,0.004693
8,14,22,629,1063829,1064458,0.000031,0.021313,0.021344
10,14,24,9265,3618553,3627818,0.000409,0.060085,0.060494
8,14,22,1125,1263457,1264582,0.000045,0.021387,0.021432
9,14,23,3825,538753,542578,0.000217,0.013945,0.014162
10,15,25,11883,763751,775634,0.000747,0.019831,0.020578
10,12,22,43072,18763,61835,0.002024,0.000542,0.002566
9,14,23,3810,560596,564406,0.000188,0.012789,0.012977
10,13,23,43319,30126,73445,0.001776,0.000763,0.002539
8,12,20,672,13543,14215,0.000030,0.000383,0.000413
10,15,25,14123,1446854,1460977,0.000640,0.031823,0.032463
9,14,23,8331,895855,904186,0.000395,0.018356,0.018751
10,15,25,8777,2228344,2237121,0.000416,0.038730,0.039146
9,10,19,5150,248,5398,0.000238,0.000005,0.000243
8,13,21,792,248145,248937,0.000034,0.004269,0.004303
10,15,25,46411,3031275,3077686,0.001890,0.053836,0.055726
9,15,24,1961,2111312,2113273,0.000094,0.034558,0.034652
10,14,24,24138,1172537,1196675,0.001033,0.019845,0.020878
9,14,23,9256,285159,294415,0.000374,0.005686,0.006060
9,15,24,5012,1333630,1338642,0.000236,0.023105,0.023341
9,14,23,3129,1853684,1856813,0.000160,0.030732,0.030892
8,14,22,363,434157,434520,0.000016,0.007284,0.007300
11,12,23,135715,18875,154590,0.004667,0.000417,0.005084
10,15,25,34166,648524,682690,0.000995,0.014753,0.015748
10,14,24,16558,1931475,1948033,0.000693,0.038047,0.038740
10,14,24,14543,1281308,1295851,0.000620,0.021408,0.022028
10,13,23,18465,41048,59513,0.000771,0.000779,0.001550
9,12,21,6624,7371,13995,0.000243,0.000164,0.000407
10,15,25,19349,1861343,1880692,0.000756,0.033053,0.033809
11,16,27,66854,4290822,4357676,0.002391,0.073237,0.075628
10,13,23,12501,256171,268672,0.000569,0.004600,0.005169
9,14,23,6445,878757,885202,0.000388,0.015809,0.016197
10,11,21,7259,24454,31713,0.000357,0.000411,0.000768
10,16,26,35068,3845912,3880980,0.001307,0.066599,0.067906
9,15,24,4218,1868719,1872937,0.000207,0.032208,0.032415
9,15,24,5926,2757942,2763868,0.000247,0.047498,0.047745
10,10,20,10100,5364,15464,0.000465,0.000091,0.000556
9,15,24,7636,1512952,1520588,0.000348,0.025883,0.026231
9,14,23,12451,220460,232911,0.000585,0.003885,0.004470
9,14,23,853,352560,353413,0.000037,0.007222,0.007259
10,15,25,11314,1494751,1506065,0.001704,0.032090,0.033794
8,15,23,237,1805330,1805567,0.000011,0.030908,0.030919
10,14,24,25216,173944,199160,0.001069,0.003277,0.004346
9,14,23,6421,181127,187548,0.000266,0.003724,0.003990
8,12,20,493,19245,19738,0.000021,0.000357,0.000378
10,14,24,28327,39629,67956,0.001114,0.000793,0.001907
9,13,22,4662,63468,68130,0.000189,0.001294,0.001483
9,13,22,11578,66680,78258,0.000449,0.001346,0.001795
10,15,25,32705,2021323,2054028,0.001254,0.040480,0.041734
10,13,23,70448,40031,110479,0.002410,0.000831,0.003241
10,15,25,10436,5325031,5335467,0.000443,0.096523,0.096966
10,13,23,25312,135180,160492,0.001015,0.002727,0.003742
10,15,25,66568,710093,776661,0.002355,0.014852,0.017207
9,15,24,5326,437102,442428,0.000240,0.009597,0.009837
10,12,22,16579,25672,42251,0.000721,0.000527,0.001248
9,13,22,4032,252936,256968,0.000193,0.005263,0.005456
10,16,26,27277,5191241,5218518,0.001168,0.120103,0.121271
9,15,24,16072,641762,657834,0.000924,0.014463,0.015387
10,16,26,20044,10492744,10512788,0.000986,0.209148,0.210134
9,14,23,1237,125648,126885,0.000069,0.002574,0.002643
10,14,24,25134,451686,476820,0.001173,0.008916,0.010089
9,14,23,2161,997992,1000153,0.000102,0.019338,0.019440
9,15,24,4897,269746,274643,0.000274,0.006592,0.006866
9,13,22,8576,63867,72443,0.000406,0.001332,0.001738
10,16,26,62279,4841714,4903993,0.002275,0.089771,0.092046
10,13,23,7225,1826793,1834018,0.000340,0.029349,0.029689
9,14,23,8063,33939,42002,0.000351,0.000626,0.000977
10,14,24,23107,232953,256060,0.000802,0.004342,0.005144
10,14,24,19645,845886,865531,0.000812,0.014689,0.015501
10,14,24,17141,478614,495755,0.000655,0.009765,0.010420
10,14,24,14851,449556,464407,0.000659,0.009228,0.009887
10,14,24,57559,2787156,2844715,0.002688,0.051296,0.053984
10,15,25,20635,3409031,3429666,0.000921,0.059814,0.060735
10,13,23,13638,90909,104547,0.000612,0.001594,0.002206
10,14,24,18701,273900,292601,0.000751,0.005013,0.005764
10,15,25,15472,1970537,1986009,0.000677,0.034218,0.034895
9,14,23,8052,361393,369445,0.000341,0.007463,0.007804
9,13,22,5245,88923,94168,0.000219,0.002154,0.002373
10,12,22,29838,17714,47552,0.001186,0.000336,0.001522
9,12,21,13532,5046,18578,0.000525,0.000126,0.000651
10,14,24,24677,686512,711189,0.001007,0.013837,0.014844
10,11,21,4858,607,5465,0.000232,0.000024,0.000256
10,15,25,10445,1604646,1615091,0.000440,0.035555,0.035995
10,14,24,45134,972429,1017563,0.002088,0.020514,0.022602
9,15,24,11157,3856362,3867519,0.000533,0.069292,0.069825
9,14,23,4428,4846620,4851048,0.000206,0.081734,0.081940
9,12,21,633,22388,23021,0.000035,0.000410,0.000445
10,14,24,48312,301582,349894,0.001968,0.005656,0.007624
9,10,19,7006,2443,9449,0.000271,0.000054,0.000325
10,14,24,6419,816345,822764,0.000266,0.013595,0.013861
10,15,25,54153,336307,390460,0.001823,0.006697,0.008520
10,16,26,96715,3785829,3882544,0.003438,0.071865,0.075303
9,15,24,4374,1436907,1441281,0.000203,0.028041,0.028244
10,15,25,31995,3041398,3073393,0.001284,0.054226,0.055510
9,13,22,4788,343847,348635,0.000236,0.006355,0.006591
9,14,23,18541,258718,277259,0.000764,0.004744,0.005508
10,13,23,23267,77987,101254,0.000782,0.001510,0.002292
10,13,23,29960,99165,129125,0.001031,0.001897,0.002928
9,15,24,19011,575599,594610,0.000683,0.012512,0.013195
8,14,22,1143,471012,472155,0.000058,0.010133,0.010191
9,15,24,8873,504574,513447,0.000369,0.009713,0.010082
10,14,24,15554,553004,568558,0.000657,0.009472,0.010129
9,15,24,2115,8219847,8221962,0.000105,0.149739,0.149844
9,15,24,12870,1049926,1062796,0.000575,0.021211,0.021786
9,14,23,1947,69654,71601,0.000108,0.001354,0.001462
9,15,24,7181,910081,917262,0.000341,0.017874,0.018215
8,13,21,641,149691,150332,0.000037,0.002815,0.002852
9,14,23,2256,623534,625790,0.000123,0.011683,0.011806
10,14,24,33900,124953,158853,0.001280,0.002557,0.003837
10,15,25,15313,1398702,1414015,0.000625,0.026613,0.027238
10,14,24,13372,1674951,1688323,0.000582,0.031595,0.032177
10,15,25,21092,1641279,1662371,0.001006,0.031304,0.032310
10,14,24,20983,905105,926088,0.000896,0.017083,0.017979
9,14,23,4298,247572,251870,0.000207,0.004819,0.005026
9,11,20,7359,9455,16814,0.000353,0.000178,0.000531
10,13,23,23456,118428,141884,0.001040,0.004078,0.005118
10,14,24,36824,371174,407998,0.001993,0.007133,0.009126
9,13,22,11078,8997,20075,0.000483,0.000216,0.000699
10,13,23,27990,308780,336770,0.001118,0.006050,0.007168
11,14,25,80138,1587182,1667320,0.002775,0.030165,0.032940
10,14,24,53575,156063,209638,0.002034,0.003303,0.005337
9,14,23,11572,243504,255076,0.000461,0.004861,0.005322
10,13,23,35598,59369,94967,0.001440,0.001438,0.002878
9,16,25,863,3184288,3185151,0.000040,0.075419,0.075459
9,15,24,8824,254218,263042,0.000431,0.007075,0.007506
9,11,20,18682,10039,28721,0.000903,0.000264,0.001167
10,14,24,10213,54018,64231,0.000529,0.001520,0.002049
10,13,23,22104,125341,147445,0.000990,0.003357,0.004347
10,14,24,32403,1158844,1191247,0.001513,0.031390,0.032903
8,13,21,578,73287,73865,0.000040,0.002006,0.002046
9,13,22,2723,32954,35677,0.000167,0.001098,0.001265
9,13,22,12217,80876,93093,0.000664,0.002277,0.002941
10,13,23,47243,519554,566797,0.002315,0.015355,0.017670
9,15,24,7205,957821,965026,0.000505,0.026964,0.027469
9,14,23,14237,5696800,5711037,0.000732,0.102757,0.103489
10,15,25,15238,1799727,1814965,0.000647,0.032838,0.033485
9,15,24,2233,1966345,1968578,0.000127,0.035763,0.035890
10,15,25,15099,1230829,1245928,0.000744,0.022293,0.023037
9,15,24,2023,2657719,2659742,0.000108,0.047396,0.047504
9,13,22,2387,41400,43787,0.000138,0.000830,0.000968
10,13,23,18591,67664,86255,0.000842,0.001341,0.002183
9,13,22,1791,161198,162989,0.000082,0.003083,0.003165
10,15,25,19673,444647,464320,0.000970,0.008368,0.009338
9,13,22,2414,4770,7184,0.000106,0.000133,0.000239
9,14,23,4314,1884202,1888516,0.000203,0.032978,0.033181
9,15,24,15893,4562406,4578299,0.000686,0.081837,0.082523
10,13,23,16714,80131,96845,0.000805,0.001646,0.002451
10,13,23,13122,137054,150176,0.000569,0.002687,0.003256
10,15,25,57475,1071111,1128586,0.002153,0.020917,0.023070
10,15,25,38947,1336738,1375685,0.001655,0.027094,0.028749
9,14,23,3944,315390,319334,0.000228,0.005838,0.006066
10,14,24,21111,2746388,2767499,0.000995,0.055858,0.056853
10,15,25,7390,1148283,1155673,0.000419,0.025933,0.026352
9,12,21,5351,78331,83682,0.000314,0.001759,0.002073
10,15,25,26475,465361,491836,0.001349,0.010692,0.012041
9,14,23,1490,1086945,1088435,0.000078,0.024117,0.024195
10,10,20,58413,1707,60120,0.002566,0.000053,0.002619
8,13,21,1242,81458,82700,0.000056,0.002098,0.002154
9,15,24,13449,786794,800243,0.000584,0.018469,0.019053
10,15,25,51448,7159087,7210535,0.002209,0.156657,0.158866
10,15,25,30673,5014611,5045284,0.001605,0.112334,0.113939
10,12,22,6136,57331,63467,0.000373,0.001224,0.001597
10,12,22,21538,42504,64042,0.001000,0.001051,0.002051
11,14,25,147894,366859,514753,0.005393,0.009090,0.014483
10,13,23,20243,132041,152284,0.000963,0.003244,0.004207
9,14,23,4995,591898,596893,0.000247,0.013458,0.013705
10,15,25,14890,493099,507989,0.000756,0.012452,0.013208
10,13,23,40423,60389,100812,0.001871,0.001608,0.003479
10,14,24,28637,56890,85527,0.001149,0.001790,0.002939
10,15,25,43368,427332,470700,0.001703,0.010792,0.012495
10,15,25,43698,654093,697791,0.001891,0.015745,0.017636
9,13,22,9487,31785,41272,0.000413,0.000778,0.001191
9,11,20,638,29455,30093,0.000031,0.000681,0.000712
10,14,24,19472,125785,145257,0.000857,0.003167,0.004024
10,13,23,17058,593352,610410,0.000729,0.012855,0.013584
10,13,23,55940,49672,105612,0.002228,0.001202,0.003430
10,14,24,21366,214990,236356,0.000877,0.005649,0.006526
10,14,24,29460,719835,749295,0.001479,0.016669,0.018148
10,14,24,12740,653474,666214,0.000659,0.014773,0.015432
9,16,25,5044,3118945,3123989,0.000262,0.063862,0.064124
10,14,24,7272,140557,147829,0.000366,0.002810,0.003176
9,15,24,1034,4307778,4308812,0.000048,0.076723,0.076771
10,14,24,21477,191492,212969,0.000873,0.003383,0.004256
9,14,23,6090,558906,564996,0.000276,0.010201,0.010477
8,15,23,1357,750564,751921,0.000060,0.013275,0.013335
10,14,24,38428,275071,313499,0.001425,0.005190,0.006615
9,13,22,3090,37247,40337,0.000138,0.000715,0.000853
10,14,24,14492,452554,467046,0.000555,0.008079,0.008634
9,14,23,6796,47754,54550,0.000238,0.000875,0.001113
9,13,22,4371,430931,435302,0.000183,0.007557,0.007740
10,15,25,14866,1280467,1295333,0.000617,0.022039,0.022656
10,12,22,20478,6877,27355,0.000954,0.000164,0.001118
9,15,24,891,12815600,12816491,0.000036,0.220115,0.220151
10,13,23,40052,35493,75545,0.001628,0.000722,0.002350
9,15,24,6513,1928802,1935315,0.000260,0.034305,0.034565
10,15,25,3681,4198621,4202302,0.000168,0.073476,0.073644
10,12,22,51171,4452,55623,0.001953,0.000124,0.002077
10,15,25,12912,1109477,1122389,0.000499,0.021348,0.021847
10,15,25,46448,1933305,1979753,0.001750,0.036381,0.038131
10,14,24,45639,153674,199313,0.001770,0.002870,0.004640
9,15,24,8749,781788,790537,0.000328,0.016488,0.016816
9,14,23,4124,806530,810654,0.000190,0.013264,0.013454
10,15,25,26959,359806,386765,0.001067,0.006532,0.007599
10,14,24,20951,141044,161995,0.000823,0.002638,0.003461
10,14,24,78105,106624,184729,0.002868,0.002375,0.005243
9,13,22,6577,26318,32895,0.000255,0.000687,0.000942
9,14,23,3959,489990,493949,0.000146,0.011108,0.011254
10,14,24,17884,141353,159237,0.000762,0.003404,0.004166
10,14,24,6770,1177731,1184501,0.000293,0.025510,0.025803
10,14,24,33389,475411,508800,0.001390,0.010588,0.011978
10,14,24,21008,91950,112958,0.000836,0.002404,0.003240
9,15,24,3775,936143,939918,0.000173,0.020002,0.020175
10,15,25,57188,2936238,2993426,0.002170,0.056211,0.058381
9,15,24,6633,1504958,1511591,0.000265,0.026261,0.026526
8,14,22,674,878215,878889,0.000032,0.015351,0.015383
8,14,22,442,74383,74825,0.000018,0.001343,0.001361
10,15,25,9103,1184230,1193333,0.000379,0.019807,0.020186
9,15,24,6237,7420911,7427148,0.000275,0.130913,0.131188
11,14,25,105551,109292,214843,0.003783,0.002866,0.006649
10,15,25,24283,1017397,1041680,0.000903,0.024574,0.025477
9,13,22,2424,142895,145319,0.000115,0.003181,0.003296
9,14,23,7111,543103,550214,0.000353,0.011628,0.011981
9,14,23,2083,333489,335572,0.000118,0.006235,0.006353
9,13,22,4164,186454,190618,0.000190,0.003439,0.003629
10,14,24,34727,236697,271424,0.001319,0.004476,0.005795
9,15,24,3831,264011,267842,0.000159,0.005437,0.005596
10,14,24,28195,43557,71752,0.001174,0.001288,0.002462
10,14,24,11904,415317,427221,0.000498,0.009317,0.009815
9,14,23,1498,281788,283286,0.000068,0.006385,0.006453
10,14,24,15600,1426172,1441772,0.000714,0.027742,0.028456
9,13,22,4144,492063,496207,0.000183,0.008548,0.008731
10,14,24,10121,535455,545576,0.000443,0.009585,0.010028
10,15,25,29474,1529780,1559254,0.001173,0.026254,0.027427
10,14,24,11058,557721,568779,0.000459,0.009537,0.009996
11,14,25,87005,84251,171256,0.003134,0.001775,0.004909
9,14,23,1513,277435,278948,0.000057,0.005658,0.005715
9,15,24,5856,341969,347825,0.000258,0.008154,0.008412
10,15,25,22758,900135,922893,0.001049,0.020144,0.021193
11,14,25,64179,183675,247854,0.002640,0.004325,0.006965
9,13,22,13403,65489,78892,0.000520,0.001603,0.002123
9,15,24,5377,268870,274247,0.000245,0.006407,0.006652
11,14,25,128912,99499,228411,0.005022,0.003134,0.008156
9,15,24,23802,2348774,2372576,0.000871,0.053703,0.054574
10,14,24,15742,173140,188882,0.000761,0.005473,0.006234
9,15,24,4949,4195268,4200217,0.000323,0.090788,0.091111
10,14,24,34597,1178820,1213417,0.001526,0.019850,0.021376
9,14,23,4650,226459,231109,0.000213,0.004067,0.004280
10,15,25,35731,465303,501034,0.001402,0.008630,0.010032
9,13,22,2451,108894,111345,0.000108,0.002011,0.002119
10,14,24,13792,174496,188288,0.000504,0.003226,0.003730
10,15,25,34566,1618348,1652914,0.001364,0.032778,0.034142
10,14,24,11691,2461233,2472924,0.000508,0.042380,0.042888
10,14,24,23678,44428,68106,0.000972,0.000920,0.001892
9,15,24,10673,2384622,2395295,0.000422,0.041362,0.041784
9,15,24,2925,787315,790240,0.000128,0.013529,0.013657
9,13,22,9520,6934,16454,0.000388,0.000177,0.000565
10,13,23,14294,85877,100171,0.000590,0.001600,0.002190
10,15,25,86630,2420626,2507256,0.003038,0.046325,0.049363
9,15,24,11422,3963547,3974969,0.000455,0.068198,0.068653
9,14,23,4455,489038,493493,0.000207,0.008582,0.008789
9,15,24,17769,470490,488259,0.000654,0.008232,0.008886
9,14,23,10100,227006,237106,0.000415,0.004061,0.004476
9,12,21,9277,87158,96435,0.000358,0.001535,0.001893
10,15,25,60278,628522,688800,0.002214,0.012627,0.014841
9,13,22,6499,302380,308879,0.000253,0.005716,0.005969
10,15,25,18734,1277590,1296324,0.000698,0.023751,0.024449
9,15,24,2335,2752817,2755152,0.000099,0.047246,0.047345
10,16,26,48326,8069838,8118164,0.001833,0.137199,0.139032
10,13,23,56831,191909,248740,0.002037,0.003391,0.005428
10,13,23,32672,469325,501997,0.001165,0.009096,0.010261
10,13,23,41322,176302,217624,0.001622,0.004089,0.005711
10,13,23,17884,56421,74305,0.000735,0.001469,0.002204
9,12,21,7058,35961,43019,0.000315,0.000877,0.001192
9,15,24,13156,161084,174240,0.000498,0.004020,0.004518
10,14,24,57698,35722,93420,0.002890,0.001445,0.004335
9,14,23,8570,379422,387992,0.000402,0.009034,0.009436
9,14,23,4772,388746,393518,0.000222,0.009037,0.009259
9,15,24,3881,316046,319927,0.000204,0.007540,0.007744
8,15,23,246,4833405,4833651,0.000012,0.086764,0.086776
10,15,25,36958,1597620,1634578,0.001472,0.028641,0.030113
10,14,24,18094,751652,769746,0.000788,0.013449,0.014237
10,12,22,21133,55359,76492,0.000842,0.001012,0.001854
8,14,22,611,350044,350655,0.000028,0.006152,0.006180
10,14,24,39954,1109894,1149848,0.001581,0.020387,0.021968
10,14,24,32390,799187,831577,0.001258,0.014514,0.015772
10,14,24,22821,509584,532405,0.000916,0.009083,0.009999
10,15,25,24599,583452,608051,0.000973,0.011499,0.012472
9,14,23,4691,1747832,1752523,0.000217,0.030499,0.030716
9,15,24,1884,2339881,2341765,0.000080,0.039780,0.039860
9,13,22,10450,79435,89885,0.000530,0.001462,0.001992
10,14,24,14566,455994,470560,0.000599,0.007741,0.008340
10,16,26,18109,3165501,3183610,0.000722,0.053289,0.054011
9,14,23,2630,854701,857331,0.000121,0.018560,0.018681
9,13,22,8387,4955,13342,0.000340,0.000173,0.000513
10,14,24,41113,778267,819380,0.001805,0.017847,0.019652
10,12,22,53740,29816,83556,0.002210,0.000788,0.002998
10,14,24,9099,1415149,1424248,0.000390,0.031206,0.031596
10,16,26,13018,2882893,2895911,0.000609,0.053020,0.053629
9,14,23,1322,223467,224789,0.000059,0.003844,0.003903
9,11,20,9465,9367,18832,0.000386,0.000159,0.000545
10,12,22,13522,41981,55503,0.000565,0.000742,0.001307
10,14,24,57346,697303,754649,0.002145,0.014074,0.016219
9,16,25,7853,14779974,14787827,0.000348,0.252665,0.253013
8,15,23,458,1047210,1047668,0.000024,0.019077,0.019101
9,15,24,1533,2582953,2584486,0.000081,0.043793,0.043874
10,14,24,36544,1763853,1800397,0.001469,0.029427,0.030896
10,14,24,16637,2381445,2398082,0.000682,0.039066,0.039748
9,14,23,8964,368665,377629,0.000387,0.006364,0.006751
10,12,22,29436,13892,43328,0.001229,0.000271,0.001500
9,14,23,23926,170260,194186,0.000833,0.003211,0.004044
10,15,25,28939,1728965,1757904,0.000871,0.033277,0.034148
8,15,23,545,1470651,1471196,0.000028,0.024385,0.024413
10,15,25,35100,1262462,1297562,0.001463,0.023726,0.025189
9,14,23,3725,475730,479455,0.000176,0.014541,0.014717
8,14,22,247,171870,172117,0.000012,0.003396,0.003408
10,14,24,64652,437732,502384,0.003131,0.009697,0.012828
10,13,23,25040,332325,357365,0.001151,0.007661,0.008812
9,13,22,6045,370816,376861,0.000309,0.008619,0.008928
9,12,21,1738,60379,62117,0.000096,0.001469,0.001565
9,15,24,1265,2245659,2246924,0.000073,0.043386,0.043459
9,15,24,12409,1500596,1513005,0.000545,0.027079,0.027624
9,16,25,1535,2345912,2347447,0.000075,0.041973,0.042048
7,15,22,550,1460375,1460925,0.000025,0.028655,0.028680
9,11,20,24823,8612,33435,0.001092,0.000242,0.001334
9,15,24,14295,1450761,1465056,0.000688,0.028920,0.029608
10,15,25,39606,8347365,8386971,0.002004,0.165195,0.167199
10,13,23,24648,183766,208414,0.001068,0.003908,0.004976
10,11,21,18887,1507,20394,0.001073,0.000043,0.001116
9,15,24,5598,1311386,1316984,0.000239,0.028701,0.028940
10,15,25,43422,869443,912865,0.001879,0.018624,0.020503
9,15,24,7503,1716734,1724237,0.000354,0.032731,0.033085
10,15,25,32537,1141158,1173695,0.001479,0.022415,0.023894
10,15,25,17230,2090549,2107779,0.000798,0.039415,0.040213
10,12,22,32359,12789,45148,0.001354,0.000314,0.001668
10,14,24,27633,86965,114598,0.001127,0.001824,0.002951
10,15,25,26079,790519,816598,0.000922,0.016822,0.017744
9,14,23,9184,645968,655152,0.000402,0.014251,0.014653
10,13,23,19311,31984,51295,0.000921,0.000792,0.001713
9,15,24,11467,1414722,1426189,0.000527,0.028365,0.028892
10,13,23,38077,90859,128936,0.001452,0.001815,0.003267
10,14,24,31501,533368,564869,0.001114,0.011292,0.012406
9,13,22,9969,22366,32335,0.000382,0.000601,0.000983
10,15,25,23920,500535,524455,0.000971,0.012065,0.013036
10,13,23,31081,76341,107422,0.001350,0.001796,0.003146
10,13,23,6102,162154,168256,0.000279,0.003497,0.003776
10,12,22,42165,172467,214632,0.001757,0.003796,0.005553
9,11,20,4254,2224,6478,0.000197,0.000066,0.000263
9,14,23,4072,667918,671990,0.000177,0.015342,0.015519
11,14,25,101316,103421,204737,0.004160,0.002769,0.006929
10,14,24,43913,306606,350519,0.001678,0.006925,0.008603
9,13,22,4844,349785,354629,0.000236,0.008253,0.008489
10,15,25,13101,2886836,2899937,0.000623,0.056396,0.057019
9,12,21,921,5740,6661,0.000050,0.000118,0.000168
9,15,24,2507,3005552,3008059,0.000124,0.050396,0.050520
10,14,24,14969,820450,835419,0.000696,0.014691,0.015387
10,12,22,30056,7175,37231,0.001156,0.000143,0.001299
9,15,24,2005,876542,878547,0.000084,0.015159,0.015243
10,13,23,13674,34783,48457,0.000594,0.000718,0.001312
9,14,23,15520,328608,344128,0.000804,0.006951,0.007755
10,13,23,21214,146996,168210,0.000890,0.002984,0.003874
10,14,24,24764,154163,178927,0.000906,0.003229,0.004135
9,14,23,3501,138085,141586,0.000179,0.003230,0.003409
9,14,23,1291,543627,544918,0.000068,0.012437,0.012505
10,13,23,18677,34560,53237,0.000952,0.000868,0.001820
10,13,23,13970,116722,130692,0.000639,0.002975,0.003614
9,14,23,7118,59022,66140,0.000332,0.001533,0.001865
9,12,21,1420,72809,74229,0.000071,0.001702,0.001773
10,13,23,26524,71391,97915,0.001260,0.001923,0.003183
10,15,25,17147,2276879,2294026,0.000714,0.045800,0.046514
10,11,21,16121,450,16571,0.000669,0.000015,0.000684
10,15,25,21420,1744805,1766225,0.000827,0.031372,0.032199
8,15,23,238,2890833,2891071,0.000010,0.056197,0.056207
9,14,23,10187,1111758,1121945,0.000504,0.025410,0.025914
10,15,25,10054,1250978,1261032,0.000459,0.025597,0.026056
10,11,21,44680,20608,65288,0.001945,0.000435,0.002380
10,13,23,29865,592368,622233,0.001071,0.012649,0.013720
10,14,24,39220,664367,703587,0.001644,0.015627,0.017271
9,14,23,5413,351305,356718,0.000265,0.008221,0.008486
9,15,24,1011,428196,429207,0.000053,0.009998,0.010051
10,15,25,10838,5589711,5600549,0.000486,0.100366,0.100852
10,14,24,52113,165595,217708,0.002258,0.003592,0.005850
10,15,25,32240,3397636,3429876,0.001226,0.061526,0.062752
9,14,23,12823,1687542,1700365,0.000558,0.028905,0.029463
10,12,22,49795,10166,59961,0.002040,0.000307,0.002347
10,15,25,16156,2993666,3009822,0.000577,0.053226,0.053803
9,10,19,21291,1202,22493,0.000715,0.000032,0.000747
10,15,25,42418,2199968,2242386,0.001441,0.041606,0.043047
10,15,25,37062,2474137,2511199,0.001546,0.045486,0.047032
9,13,22,3946,211753,215699,0.000191,0.003902,0.004093
9,15,24,1149,757005,758154,0.000063,0.014049,0.014112
10,14,24,19472,223270,242742,0.000910,0.004236,0.005146
8,15,23,2117,2098005,2100122,0.000091,0.038859,0.038950
10,15,25,24284,1820759,1845043,0.001070,0.035240,0.036310
9,14,23,1896,73459,75355,0.000097,0.001812,0.001909
9,13,22,8455,126084,134539,0.000395,0.002513,0.002908
10,16,26,79026,1364021,1443047,0.003005,0.029982,0.032987
8,15,23,396,3332424,3332820,0.000023,0.060397,0.060420
9,14,23,2419,1384242,1386661,0.000120,0.025292,0.025412
10,15,25,47394,1167668,1215062,0.001781,0.021878,0.023659
9,14,23,4306,21702,26008,0.000216,0.000608,0.000824
8,16,24,521,3779676,3780197,0.000025,0.075152,0.075177
9,15,24,4411,769816,774227,0.000261,0.018503,0.018764
10,15,25,8274,1642636,1650910,0.000451,0.041077,0.041528
10,14,24,41691,367756,409447,0.001814,0.009414,0.011228
9,14,23,4103,175542,179645,0.000236,0.004418,0.004654
10,14,24,9321,2231630,2240951,0.000496,0.050841,0.051337
9,15,24,8326,1526484,1534810,0.000432,0.032203,0.032635
8,13,21,526,215835,216361,0.000028,0.003917,0.003945
10,12,22,10021,9614,19635,0.000468,0.000222,0.000690
10,14,24,11268,791961,803229,0.000594,0.014821,0.015415
10,14,24,7715,1210460,1218175,0.000367,0.021715,0.022082
10,13,23,24686,286173,310859,0.001120,0.005821,0.006941
8,15,23,462,4283212,4283674,0.000021,0.088284,0.088305
9,13,22,9287,312996,322283,0.000484,0.005732,0.006216
10,14,24,34887,2183303,2218190,0.001556,0.040552,0.042108
8,16,24,744,2192299,2193043,0.000046,0.042096,0.042142
8,14,22,166,572613,572779,0.000007,0.010213,0.010220
10,15,25,36036,1486281,1522317,0.001646,0.027296,0.028942
10,14,24,10429,2412936,2423365,0.000482,0.044126,0.044608
10,14,24,17380,930011,947391,0.000810,0.016786,0.017596
10,15,25,10458,904019,914477,0.000502,0.018593,0.019095
9,15,24,23883,417455,441338,0.001066,0.008326,0.009392
10,14,24,44986,714688,759674,0.001776,0.013897,0.015673
10,14,24,23715,224323,248038,0.001000,0.004652,0.005652
9,15,24,5617,930149,935766,0.000242,0.019669,0.019911
9,15,24,14428,602866,617294,0.000557,0.012030,0.012587
10,14,24,58654,111773,170427,0.002407,0.002801,0.005208
10,15,25,46322,450737,497059,0.002081,0.011321,0.013402
9,15,24,5157,498172,503329,0.000300,0.012909,0.013209
9,14,23,14756,1094594,1109350,0.000800,0.030762,0.031562
9,13,22,8697,57304,66001,0.000468,0.001421,0.001889
10,15,25,69959,1714181,1784140,0.003051,0.039505,0.042556
10,14,24,9493,717443,726936,0.000481,0.016447,0.016928
10,14,24,11742,172340,184082,0.000648,0.004101,0.004749
10,13,23,15620,259630,275250,0.000763,0.005951,0.006714
10,14,24,24438,237252,261690,0.001137,0.005750,0.006887
10,14,24,31494,80321,111815,0.001384,0.002153,0.003537
8,14,22,291,1687826,1688117,0.000013,0.037038,0.037051
9,15,24,8876,2563056,2571932,0.000473,0.058015,0.058488
10,13,23,52522,429814,482336,0.002523,0.009948,0.012471
9,14,23,10533,1026888,1037421,0.000532,0.024236,0.024768
9,13,22,1793,24683,26476,0.000105,0.000658,0.000763
10,15,25,52240,970503,1022743,0.002376,0.024442,0.026818
10,15,25,29348,719945,749293,0.001395,0.018178,0.019573
9,15,24,4755,3174154,3178909,0.000259,0.072649,0.072908
11,15,26,135558,549242,684800,0.005589,0.013678,0.019267
9,13,22,5222,649941,655163,0.000252,0.014682,0.014934
10,14,24,48102,1131861,1179963,0.002065,0.026203,0.028268
10,14,24,18132,550310,568442,0.000914,0.012360,0.013274
10,15,25,16189,1053072,1069261,0.000796,0.022709,0.023505
10,11,21,24508,15466,39974,0.001004,0.000299,0.001303
9,15,24,7077,6535427,6542504,0.000305,0.116723,0.117028
9,14,23,8967,1010879,1019846,0.000469,0.018337,0.018806
10,12,22,8125,9886,18011,0.000392,0.000241,0.000633
10,15,25,41773,468892,510665,0.001642,0.012717,0.014359
9,15,24,4890,726830,731720,0.000239,0.017545,0.017784
10,14,24,16873,10403716,10420589,0.000895,0.171872,0.172767
8,12,20,454,68875,69329,0.000022,0.001119,0.001141
8,14,22,416,1085390,1085806,0.000020,0.018460,0.018480
9,15,24,7818,620411,628229,0.000341,0.011185,0.011526
9,15,24,3991,980525,984516,0.000184,0.016452,0.016636
10,14,24,15443,734251,749694,0.000663,0.012763,0.013426
10,15,25,33575,2654137,2687712,0.001348,0.044108,0.045456
9,12,21,1150,2126,3276,0.000054,0.000056,0.000110
10,15,25,46264,1835356,1881620,0.001828,0.031953,0.033781
10,14,24,14929,63702,78631,0.000710,0.001193,0.001903
10,16,26,21905,3016216,3038121,0.001317,0.071406,0.072723
10,13,23,18742,1075,19817,0.000959,0.000037,0.000996
10,15,25,17054,490985,508039,0.000793,0.011058,0.011851
10,14,24,10434,84473,94907,0.000496,0.002117,0.002613
10,15,25,12925,2344375,2357300,0.000591,0.046640,0.047231
10,15,25,24699,1485794,1510493,0.001072,0.025016,0.026088
9,15,24,5646,1771452,1777098,0.000229,0.029896,0.030125
9,14,23,5320,227752,233072,0.000242,0.004592,0.004834
10,14,24,6958,177873,184831,0.000327,0.003264,0.003591
9,14,23,8482,1026153,1034635,0.000348,0.016883,0.017231
10,14,24,11325,280205,291530,0.000466,0.004981,0.005447
10,14,24,17763,454146,471909,0.000738,0.007820,0.008558
10,14,24,14824,201066,215890,0.000659,0.003708,0.004367
8,14,22,725,6323115,6323840,0.000033,0.102335,0.102368
9,14,23,3197,546488,549685,0.000149,0.009414,0.009563
9,14,23,5803,733209,739012,0.000241,0.012615,0.012856
10,14,24,27595,307164,334759,0.001076,0.005583,0.006659
9,14,23,4585,14929,19514,0.000186,0.000361,0.000547
9,14,23,9283,357261,366544,0.000314,0.006351,0.006665
9,15,24,7542,499232,506774,0.000312,0.008716,0.009028
10,13,23,20056,27294,47350,0.000826,0.000515,0.001341
8,14,22,859,355504,356363,0.000036,0.006277,0.006313
10,15,25,56922,1211468,1268390,0.002123,0.025155,0.027278
10,14,24,16079,400351,416430,0.000640,0.007158,0.007798
10,15,25,47070,919025,966095,0.001759,0.019151,0.020910
10,13,23,18488,239780,258268,0.000829,0.005413,0.006242
10,15,25,13407,1787799,1801206,0.000609,0.035438,0.036047
10,13,23,24266,145791,170057,0.000968,0.002581,0.003549
10,15,25,22154,1626177,1648331,0.000894,0.029659,0.030553
10,15,25,45028,5750104,5795132,0.001572,0.096406,0.097978
10,14,24,38353,367841,406194,0.001464,0.006617,0.008081
9,13,22,1605,85136,86741,0.000071,0.001573,0.001644
10,13,23,22418,170508,192926,0.000943,0.002993,0.003936
8,14,22,1808,1131986,1133794,0.000073,0.020576,0.020649
10,14,24,12641,406851,419492,0.000563,0.014241,0.014804
9,14,23,3489,9165848,9169337,0.000191,0.153966,0.154157
9,13,22,3655,6229,9884,0.000179,0.000192,0.000371
10,16,26,33028,4154580,4187608,0.001383,0.068866,0.070249
10,14,24,19398,721230,740628,0.000829,0.012251,0.013080
9,14,23,1715,578317,580032,0.000072,0.010076,0.010148
11,15,26,126595,1669148,1795743,0.004384,0.036324,0.040708
10,15,25,9308,790149,799457,0.000458,0.015720,0.016178
10,13,23,25538,18181,43719,0.001079,0.000376,0.001455
9,13,22,1399,95844,97243,0.000057,0.001828,0.001885
9,15,24,904,22654490,22655394,0.000038,0.363744,0.363782
9,12,21,7835,3088,10923,0.000389,0.000091,0.000480
9,16,25,4868,6311135,6316003,0.000210,0.106285,0.106495
8,15,23,2736,309288,312024,0.000135,0.005231,0.005366
9,15,24,8515,5455123,5463638,0.000398,0.086599,0.086997
10,14,24,19430,184247,203677,0.000820,0.003628,0.004448
9,13,22,7861,424420,432281,0.000318,0.007357,0.007675
9,14,23,4993,332987,337980,0.000214,0.005937,0.006151
10,14,24,36211,1720963,1757174,0.001452,0.027093,0.028545
9,15,24,2938,1449543,1452481,0.000128,0.025041,0.025169
10,14,24,9217,239009,248226,0.000416,0.004280,0.004696
9,15,24,11460,555842,567302,0.000474,0.009789,0.010263
10,15,25,28957,1626171,1655128,0.001053,0.030078,0.031131
10,15,25,56621,689363,745984,0.005782,0.014727,0.020509
9,16,25,6044,5165345,5171389,0.000288,0.092977,0.093265
9,14,23,2308,436732,439040,0.000126,0.007963,0.008089
9,14,23,3798,418224,422022,0.000168,0.007827,0.007995
8,14,22,847,479458,480305,0.000043,0.008801,0.008844
9,15,24,907,1393728,1394635,0.000046,0.025164,0.025210
9,15,24,5682,1462234,1467916,0.000247,0.025742,0.025989
10,13,23,33913,136013,169926,0.001407,0.002448,0.003855
10,14,24,41496,804301,845797,0.001517,0.016154,0.017671
10,13,23,62503,842702,905205,0.002272,0.017501,0.019773
9,13,22,5137,33029,38166,0.000235,0.000738,0.000973
9,13,22,1489,197150,198639,0.000067,0.004076,0.004143
10,14,24,22769,219814,242583,0.000862,0.005089,0.005951
10,13,23,21412,212840,234252,0.000970,0.004854,0.005824
11,15,26,66749,12168327,12235076,0.002276,0.214756,0.217032
9,15,24,8765,1609295,1618060,0.000397,0.027988,0.028385
10,14,24,33972,560624,594596,0.001330,0.010246,0.011576
9,15,24,8956,1238331,1247287,0.000330,0.021619,0.021949
9,14,23,4880,283106,287986,0.000179,0.004948,0.005127
9,12,21,9103,47481,56584,0.000362,0.000784,0.001146
10,15,25,9582,1217424,1227006,0.000423,0.020584,0.021007
10,16,26,56747,929019,985766,0.002118,0.017649,0.019767
10,14,24,35075,1107872,1142947,0.001326,0.020691,0.022017
10,15,25,12997,4929831,4942828,0.000505,0.084680,0.085185
10,15,25,49360,561029,610389,0.002022,0.010324,0.012346
10,13,23,37524,264756,302280,0.001328,0.005179,0.006507
10,14,24,89047,315358,404405,0.003243,0.007496,0.010739
10,14,24,7544,742535,750079,0.000349,0.017011,0.017360
10,14,24,18483,2276317,2294800,0.000892,0.043478,0.044370
9,15,24,4079,1722671,1726750,0.000186,0.031915,0.032101
10,15,25,5830,537872,543702,0.000230,0.009747,0.009977
9,14,23,1625,398534,400159,0.000069,0.006951,0.007020
9,15,24,3107,1053173,1056280,0.000144,0.017845,0.017989
8,13,21,3304,274628,277932,0.000131,0.004632,0.004763
10,14,24,26992,1710989,1737981,0.000980,0.029108,0.030088
10,14,24,41556,1880502,1922058,0.001608,0.031299,0.032907
10,11,21,20767,4896,25663,0.000807,0.000099,0.000906
9,13,22,2813,113351,116164,0.000118,0.002048,0.002166
10,15,25,46451,982317,1028768,0.001712,0.019558,0.021270
10,14,24,20660,1119174,1139834,0.000835,0.026782,0.027617
9,14,23,4115,2102104,2106219,0.000209,0.041823,0.042032
9,13,22,6455,255382,261837,0.000353,0.005398,0.005751
9,14,23,3215,2465523,2468738,0.000157,0.045843,0.046000
9,16,25,6588,6283288,6289876,0.000323,0.122121,0.122444
9,14,23,6728,183481,190209,0.000342,0.003565,0.003907
10,14,24,23002,421509,444511,0.001077,0.009333,0.010410
10,15,25,17025,1356704,1373729,0.000874,0.028074,0.028948
10,14,24,84785,801859,886644,0.003142,0.017835,0.020977
8,14,22,908,1166673,1167581,0.000053,0.025508,0.025561
9,15,24,1977,270686,272663,0.000106,0.005100,0.005206
9,14,23,9982,69993,79975,0.000452,0.001456,0.001908
9,14,23,5602,344487,350089,0.000267,0.007190,0.007457
9,14,23,2394,1670945,1673339,0.000118,0.032291,0.032409
9,15,24,11244,1637753,1648997,0.000466,0.030261,0.030727
9,14,23,7027,149917,156944,0.000343,0.003286,0.003629
11,14,25,65148,69126,134274,0.002287,0.001505,0.003792
10,14,24,17600,988182,1005782,0.000662,0.021661,0.022323
10,14,24,27417,332033,359450,0.001086,0.007757,0.008843
9,14,23,17799,570482,588281,0.000682,0.012958,0.013640
9,15,24,5671,926688,932359,0.000276,0.018078,0.018354
10,14,24,11756,602724,614480,0.000542,0.010453,0.010995
10,13,23,36611,410513,447124,0.001370,0.007992,0.009362
9,13,22,2910,37653,40563,0.000137,0.000864,0.001001
10,15,25,32516,1053143,1085659,0.001313,0.023690,0.025003
10,15,25,20697,3883035,3903732,0.000939,0.073016,0.073955
9,16,25,10269,5005310,5015579,0.000463,0.085425,0.085888
10,16,26,12481,2358104,2370585,0.000552,0.042086,0.042638
10,12,22,26731,24037,50768,0.001114,0.000879,0.001993
10,14,24,13024,1133653,1146677,0.000649,0.020837,0.021486
9,14,23,6258,157383,163641,0.000295,0.003039,0.003334
10,14,24,38299,1184630,1222929,0.001595,0.022072,0.023667
9,14,23,3350,456619,459969,0.000161,0.008054,0.008215
10,13,23,42037,284591,326628,0.001630,0.005398,0.007028
10,14,24,22412,243907,266319,0.000932,0.005398,0.006330
10,11,21,15444,3180,18624,0.000670,0.000103,0.000773
10,14,24,38449,1149850,1188299,0.001597,0.025571,0.027168
10,14,24,37160,117944,155104,0.001619,0.002962,0.004581
10,14,24,15717,49165,64882,0.000722,0.001460,0.002182
10,14,24,25209,370533,395742,0.001015,0.008556,0.009571
10,13,23,8995,252603,261598,0.000414,0.005716,0.006130
10,14,24,6042,480290,486332,0.000302,0.010992,0.011294
9,14,23,20548,387603,408151,0.000828,0.008427,0.009255
10,14,24,15820,850994,866814,0.000710,0.017912,0.018622
10,15,25,42481,1397690,1440171,0.001675,0.027681,0.029356
10,14,24,10168,2663644,2673812,0.000463,0.047477,0.047940
10,14,24,54492,407772,462264,0.002081,0.007483,0.009564
10,13,23,31429,100870,132299,0.001198,0.001799,0.002997
9,15,24,4797,1815934,1820731,0.000168,0.043989,0.044157
9,14,23,3934,583695,587629,0.000193,0.013218,0.013411
9,15,24,4598,515256,519854,0.000244,0.009751,0.009995
9,14,23,4404,969084,973488,0.000172,0.016791,0.016963
10,13,23,17087,31049,48136,0.000783,0.000624,0.001407
10,14,24,15598,211052,226650,0.000699,0.004413,0.005112
10,13,23,21541,10337,31878,0.000996,0.000298,0.001294
9,15,24,9417,3428077,3437494,0.000408,0.070683,0.071091
9,15,24,2986,239500,242486,0.000155,0.004873,0.005028
10,14,24,44111,549587,593698,0.001742,0.011073,0.012815
10,15,25,22627,588079,610706,0.000897,0.013494,0.014391
10,16,26,46563,2502523,2549086,0.001845,0.049129,0.050974
8,14,22,3248,510254,513502,0.000127,0.008675,0.008802
9,15,24,1339,933135,934474,0.000061,0.016857,0.016918
8,13,21,643,164106,164749,0.000031,0.002840,0.002871
11,14,25,103190,1077244,1180434,0.003744,0.024557,0.028301
9,14,23,8871,326674,335545,0.000462,0.007412,0.007874
10,15,25,18921,1456148,1475069,0.000980,0.030115,0.031095
9,15,24,3508,1259670,1263178,0.000222,0.022945,0.023167
9,14,23,22135,261132,283267,0.000868,0.004894,0.005762
9,14,23,1164,896868,898032,0.000057,0.016180,0.016237
10,16,26,21432,2721844,2743276,0.000979,0.051405,0.052384
10,13,23,19995,366520,386515,0.000892,0.007137,0.008029
8,13,21,2775,464920,467695,0.000123,0.008517,0.008640
10,15,25,10621,1304035,1314656,0.000483,0.023985,0.024468
10,13,23,21664,299816,321480,0.000944,0.005741,0.006685
6,16,22,136,2735650,2735786,0.000005,0.053045,0.053050
10,13,23,79848,27383,107231,0.003120,0.000624,0.003744
10,14,24,35207,7212008,7247215,0.001258,0.144047,0.145305
9,14,23,4894,13684,18578,0.000277,0.000590,0.000867
10,15,25,139517,2242729,2382246,0.005387,0.053866,0.059253
10,14,24,6794,827467,834261,0.000409,0.018831,0.019240
10,14,24,20125,79256,99381,0.001036,0.002184,0.003220
9,14,23,1418,318183,319601,0.000076,0.007400,0.007476
10,15,25,28177,1490830,1519007,0.001254,0.041071,0.042325
10,14,24,12977,872900,885877,0.000684,0.019926,0.020610
10,14,24,66188,137035,203223,0.002621,0.003452,0.006073
8,13,21,8972,731,9703,0.000347,0.000029,0.000376
10,15,25,23681,9314736,9338417,0.000991,0.170430,0.171421
9,14,23,10833,1023358,1034191,0.000491,0.027145,0.027636
10,14,24,12567,258367,270934,0.000664,0.005860,0.006524
10,15,25,25732,3517356,3543088,0.001150,0.064617,0.065767
8,15,23,629,1616274,1616903,0.000039,0.029664,0.029703
10,14,24,68507,181862,250369,0.002623,0.003860,0.006483
9,15,24,10892,1947220,1958112,0.000444,0.035510,0.035954
10,12,22,21745,3273,25018,0.000928,0.000102,0.001030
10,13,23,22803,31024,53827,0.000957,0.000732,0.001689
10,13,23,61983,115655,177638,0.002235,0.002655,0.004890
9,12,21,1753,11978,13731,0.000079,0.000322,0.000401
10,15,25,37742,526815,564557,0.001414,0.012948,0.014362
10,11,21,52483,1723,54206,0.002165,0.000077,0.002242
9,13,22,3638,159260,162898,0.000180,0.004090,0.004270
10,12,22,15864,16491,32355,0.000752,0.000504,0.001256
10,13,23,32712,387830,420542,0.001344,0.009197,0.010541
9,15,24,4574,3515485,3520059,0.000234,0.075755,0.075989
10,15,25,5029,1524562,1529591,0.000294,0.036490,0.036784
10,15,25,24116,541899,566015,0.001248,0.012496,0.013744
10,15,25,43324,1026180,1069504,0.001966,0.023521,0.025487
10,15,25,15377,1877280,1892657,0.000792,0.052975,0.053767
9,15,24,5449,2699995,2705444,0.000324,0.058884,0.059208
10,14,24,44096,1387289,1431385,0.002150,0.031080,0.033230
10,15,25,36331,564473,600804,0.001769,0.012749,0.014518
10,13,23,14776,54385,69161,0.000658,0.001319,0.001977
9,13,22,9194,422446,431640,0.000418,0.009968,0.010386
10,15,25,65846,230589,296435,0.002970,0.006058,0.009028
10,15,25,60916,2865523,2926439,0.002782,0.066730,0.069512
10,14,24,19132,254442,273574,0.000998,0.005946,0.006944
10,14,24,21176,142219,163395,0.001022,0.003525,0.004547
9,14,23,7849,3117050,3124899,0.000380,0.065413,0.065793
11,14,25,75506,2543401,2618907,0.003235,0.053618,0.056853
9,15,24,8897,1108062,1116959,0.000400,0.019193,0.019593
10,14,24,6222,8194,14416,0.000293,0.000195,0.000488
10,14,24,23678,732222,755900,0.001004,0.012758,0.013762
9,13,22,1986,276684,278670,0.000082,0.004820,0.004902
8,14,22,953,244987,245940,0.000043,0.004416,0.004459
9,15,24,3237,1291519,1294756,0.000141,0.022239,0.022380
10,13,23,39161,574753,613914,0.001359,0.009743,0.011102
10,12,22,56910,157754,214664,0.002183,0.003077,0.005260
10,15,25,31124,1159352,1190476,0.001115,0.025288,0.026403
11,15,26,131039,2827738,2958777,0.005089,0.056071,0.061160
10,13,23,42440,671396,713836,0.001795,0.013396,0.015191
10,15,25,14221,483959,498180,0.000662,0.011037,0.011699
10,14,24,17012,1031655,1048667,0.000821,0.022286,0.023107
9,13,22,2215,140786,143001,0.000112,0.002573,0.002685
10,15,25,47854,2108916,2156770,0.001788,0.047864,0.049652
9,14,23,3986,95209,99195,0.000214,0.002203,0.002417
9,14,23,5184,693037,698221,0.000229,0.013321,0.013550
10,16,26,14685,3428715,3443400,0.000664,0.061836,0.062500
9,15,24,1917,1447679,1449596,0.000149,0.027391,0.027540
8,14,22,955,298638,299593,0.000045,0.005713,0.005758
9,14,23,2460,139415,141875,0.000122,0.002639,0.002761
10,15,25,8949,806805,815754,0.000420,0.014509,0.014929
10,14,24,33108,392527,425635,0.001345,0.007485,0.008830
10,13,23,51092,102639,153731,0.001947,0.002064,0.004011
10,15,25,14619,1789936,1804555,0.000654,0.035736,0.036390
9,15,24,4177,2152710,2156887,0.000188,0.035651,0.035839
9,14,23,2748,236267,239015,0.000134,0.004204,0.004338
8,13,21,647,60118,60765,0.000029,0.001108,0.001137
10,13,23,18042,75592,93634,0.000794,0.001421,0.002215
11,16,27,97150,5173698,5270848,0.003235,0.094389,0.097624
10,13,23,23238,162849,186087,0.000916,0.002908,0.003824
10,15,25,98173,1390054,1488227,0.003073,0.026867,0.029940
10,12,22,85476,86361,171837,0.002594,0.001682,0.004276
9,13,22,5758,74804,80562,0.000222,0.001405,0.001627
10,15,25,131635,525301,656936,0.003976,0.013406,0.017382
10,15,25,22945,801044,823989,0.000999,0.023988,0.024987
10,12,22,15050,6146,21196,0.000853,0.000202,0.001055
9,13,22,4791,1499,6290,0.000232,0.000063,0.000295
9,14,23,2450,252492,254942,0.000136,0.006425,0.006561
9,15,24,11776,1244284,1256060,0.000547,0.028137,0.028684
10,15,25,67440,1280910,1348350,0.002898,0.028947,0.031845
10,15,25,75699,505257,580956,0.002827,0.012573,0.015400
10,15,25,43752,256690,300442,0.001783,0.006236,0.008019
9,13,22,809,352629,353438,0.000040,0.008067,0.008107
9,14,23,4080,1046414,1050494,0.000191,0.022369,0.022560
10,12,22,6762,16536,23298,0.000318,0.000362,0.000680
9,13,22,1462,271352,272814,0.000067,0.004903,0.004970
9,10,19,21026,3153,24179,0.000817,0.000055,0.000872
10,15,25,17447,603630,621077,0.000675,0.012589,0.013264
10,13,23,19151,86491,105642,0.000801,0.002028,0.002829
9,14,23,2755,607363,610118,0.000135,0.012824,0.012959
10,15,25,16380,2750389,2766769,0.000747,0.048888,0.049635
9,14,23,10286,1790954,1801240,0.000417,0.030243,0.030660
10,15,25,23895,2931573,2955468,0.000913,0.050875,0.051788
9,15,24,10180,430782,440962,0.000436,0.007832,0.008268
9,14,23,6065,4896684,4902749,0.000264,0.082755,0.083019
9,15,24,1564,602532,604096,0.000072,0.010460,0.010532
10,13,23,18340,208343,226683,0.000800,0.003721,0.004521
10,14,24,12172,143733,155905,0.000535,0.002664,0.003199
10,15,25,24386,710926,735312,0.000907,0.012449,0.013356
10,13,23,17554,278509,296063,0.000737,0.004800,0.005537
9,14,23,2876,633587,636463,0.000128,0.011052,0.011180
10,14,24,22206,213168,235374,0.000843,0.003936,0.004779
10,15,25,90299,5297682,5387981,0.003039,0.096444,0.099483
9,14,23,4815,3813921,3818736,0.000209,0.072237,0.072446
10,13,23,29023,111860,140883,0.001223,0.002563,0.003786
10,13,23,4595,227436,232031,0.000234,0.004740,0.004974
10,15,25,18518,1068289,1086807,0.000952,0.023356,0.024308
10,15,25,12570,847154,859724,0.000543,0.015011,0.015554
10,15,25,30243,2953834,2984077,0.001156,0.054148,0.055304
10,15,25,25663,1285033,1310696,0.001081,0.024183,0.025264
10,15,25,70681,1071100,1141781,0.002617,0.021900,0.024517
9,15,24,1969,330183,332152,0.000097,0.005848,0.005945
10,14,24,20761,105661,126422,0.000909,0.001896,0.002805
10,15,25,30768,939570,970338,0.001238,0.020006,0.021244
9,15,24,6485,1062442,1068927,0.000306,0.020089,0.020395
9,13,22,29745,220364,250109,0.001006,0.003736,0.004742
9,14,23,5343,291287,296630,0.000231,0.005227,0.005458
9,13,22,9068,89670,98738,0.000368,0.001714,0.002082
10,14,24,20119,152717,172836,0.000801,0.002905,0.003706
10,14,24,13830,1340169,1353999,0.000574,0.026675,0.027249
9,14,23,10943,391715,402658,0.000446,0.006962,0.007408
10,14,24,32047,7558775,7590822,0.001242,0.123728,0.124970
10,14,24,9097,1663588,1672685,0.000448,0.029212,0.029660
11,15,26,112392,4085276,4197668,0.003853,0.075233,0.079086
9,13,22,1195,141555,142750,0.000059,0.002559,0.002618
10,15,25,24945,1338977,1363922,0.000915,0.023504,0.024419
9,15,24,9419,510456,519875,0.000410,0.009071,0.009481
9,15,24,9501,2248619,2258120,0.000408,0.038732,0.039140
10,12,22,24095,40057,64152,0.000968,0.000773,0.001741
10,15,25,16081,708751,724832,0.000641,0.012378,0.013019
9,15,24,1217,1568953,1570170,0.000044,0.026329,0.026373
10,15,25,66794,588643,655437,0.002513,0.011771,0.014284
10,15,25,9941,769493,779434,0.000468,0.017797,0.018265
10,15,25,47718,1402433,1450151,0.001820,0.029815,0.031635
9,15,24,2758,475994,478752,0.000109,0.008329,0.008438
9,16,25,7722,17708935,17716657,0.000325,0.293614,0.293939
11,12,23,139024,52001,191025,0.008363,0.002249,0.010612
10,13,23,48458,100588,149046,0.001861,0.002486,0.004347
9,13,22,6459,379923,386382,0.000263,0.008215,0.008478
9,14,23,3601,610127,613728,0.000184,0.014009,0.014193
10,15,25,9983,673217,683200,0.000496,0.016994,0.017490
10,14,24,31318,1131415,1162733,0.001415,0.024587,0.026002
10,13,23,23319,351626,374945,0.000999,0.007056,0.008055
10,14,24,47669,219673,267342,0.001946,0.005028,0.006974
10,13,23,19174,185768,204942,0.000859,0.004320,0.005179
10,14,24,8084,1597972,1606056,0.000358,0.034063,0.034421
9,13,22,6068,28348,34416,0.000282,0.000535,0.000817
10,15,25,11544,1347220,1358764,0.000484,0.025660,0.026144
9,14,23,7913,131751,139664,0.000349,0.002395,0.002744
10,15,25,26009,566789,592798,0.001097,0.010152,0.011249
10,14,24,17698,249898,267596,0.000733,0.004523,0.005256
10,14,24,13566,357683,371249,0.000507,0.006385,0.006892
10,15,25,29088,2411669,2440757,0.001164,0.044222,0.045386
10,13,23,25998,144967,170965,0.001038,0.002461,0.003499
10,15,25,65668,2096370,2162038,0.002299,0.040045,0.042344
10,11,21,11606,9333,20939,0.000516,0.000189,0.000705
10,12,22,12015,19357,31372,0.000446,0.000424,0.000870
10,11,21,51411,3837,55248,0.001747,0.000077,0.001824
11,16,27,174427,4292428,4466855,0.005297,0.089856,0.095153
9,13,22,2394,270961,273355,0.000109,0.004696,0.004805
10,14,24,27615,416150,443765,0.001177,0.007313,0.008490
10,14,24,30391,529879,560270,0.001074,0.009296,0.010370
10,15,25,13481,710934,724415,0.000529,0.012206,0.012735
8,14,22,924,316903,317827,0.000037,0.005221,0.005258
10,13,23,9954,543537,553491,0.000434,0.009012,0.009446
10,15,25,26366,2671859,2698225,0.001066,0.045078,0.046144
9,14,23,13191,1205917,1219108,0.000550,0.019404,0.019954
10,13,23,15075,118747,133822,0.000685,0.002105,0.002790
8,14,22,716,170075,170791,0.000029,0.003108,0.003137
9,15,24,4424,818171,822595,0.000199,0.013886,0.014085
10,15,25,16163,1190428,1206591,0.000655,0.020258,0.020913
10,14,24,46253,700662,746915,0.002155,0.012760,0.014915
10,15,25,14838,4398005,4412843,0.000616,0.071905,0.072521
10,12,22,85531,67448,152979,0.003005,0.001427,0.004432
8,13,21,540,50822,51362,0.000019,0.001048,0.001067
9,15,24,4817,4513855,4518672,0.000185,0.078115,0.078300
10,13,23,15453,283370,298823,0.000685,0.005003,0.005688
9,14,23,8582,655694,664276,0.000364,0.011554,0.011918
8,14,22,730,98585,99315,0.000028,0.001817,0.001845
10,15,25,17122,1317272,1334394,0.000696,0.022159,0.022855
10,12,22,29032,7813,36845,0.001140,0.000190,0.001330
9,15,24,9953,2212788,2222741,0.000467,0.039415,0.039882
9,14,23,2709,1352373,1355082,0.000115,0.023559,0.023674
8,14,22,935,1611914,1612849,0.000043,0.027359,0.027402
9,14,23,5446,213344,218790,0.000252,0.003677,0.003929
10,14,24,29852,962494,992346,0.001138,0.015819,0.016957
9,15,24,3700,17693556,17697256,0.000160,0.326953,0.327113
9,15,24,1677,1209713,1211390,0.000097,0.023617,0.023714
10,14,24,45926,1130691,1176617,0.002035,0.022358,0.024393
10,14,24,20335,426924,447259,0.001207,0.009021,0.010228
9,15,24,10377,2388606,2398983,0.000508,0.049633,0.050141
10,14,24,8904,1170069,1178973,0.000443,0.021608,0.022051
10,15,25,21474,392431,413905,0.000922,0.008137,0.009059
10,12,22,23332,46766,70098,0.001044,0.000931,0.001975
9,13,22,1885,386798,388683,0.000089,0.007057,0.007146
9,11,20,6096,2560,8656,0.000275,0.000068,0.000343
10,15,25,19211,1118364,1137575,0.000808,0.021036,0.021844
10,15,25,11857,1600644,1612501,0.000495,0.030492,0.030987
10,14,24,12227,183807,196034,0.000568,0.003310,0.003878
10,13,23,18225,763518,781743,0.000743,0.012884,0.013627
10,13,23,37438,128676,166114,0.001451,0.002315,0.003766
9,15,24,7093,3116623,3123716,0.000288,0.054167,0.054455
10,14,24,75639,442610,518249,0.002761,0.008854,0.011615
9,14,23,7543,231170,238713,0.000326,0.005207,0.005533
10,14,24,16369,1883546,1899915,0.000768,0.037115,0.037883
10,14,24,24933,134515,159448,0.001144,0.004309,0.005453
10,14,24,28618,2949940,2978558,0.001217,0.053483,0.054700
10,13,23,31569,330283,361852,0.001300,0.005718,0.007018
8,14,22,269,1230392,1230661,0.000010,0.021218,0.021228
10,14,24,11915,388021,399936,0.000503,0.006604,0.007107
9,14,23,3666,487194,490860,0.000165,0.008464,0.008629
10,14,24,40954,1135059,1176013,0.001561,0.020013,0.021574
10,14,24,22215,1079471,1101686,0.000900,0.017909,0.018809
10,13,23,27481,107975,135456,0.001082,0.002829,0.003911
8,15,23,514,1220343,1220857,0.000024,0.023625,0.023649
10,15,25,23883,257915,281798,0.000935,0.005068,0.006003
10,14,24,19964,175465,195429,0.000847,0.003819,0.004666
9,14,23,2071,343300,345371,0.000104,0.007652,0.007756
10,12,22,30439,22698,53137,0.001401,0.000595,0.001996
10,12,22,64767,109427,174194,0.002514,0.002595,0.005109
10,13,23,28997,197756,226753,0.001148,0.004428,0.005576
9,14,23,1102,104203,105305,0.000046,0.002446,0.002492
10,13,23,8040,118078,126118,0.000333,0.002772,0.003105
9,13,22,8557,39725,48282,0.000357,0.001015,0.001372
10,12,22,50457,10032,60489,0.001977,0.000328,0.002305
9,14,23,3703,3051533,3055236,0.000163,0.057498,0.057661
9,15,24,16119,951702,967821,0.000636,0.016517,0.017153
10,9,19,15653,160,15813,0.000658,0.000004,0.000662
10,14,24,10788,486729,497517,0.000413,0.008427,0.008840
10,14,24,13109,146155,159264,0.000528,0.002995,0.003523
9,13,22,3339,116211,119550,0.000138,0.002055,0.002193
10,13,23,88201,20574,108775,0.002694,0.000485,0.003179
10,14,24,33117,40073,73190,0.001056,0.001043,0.002099
8,14,22,697,48016,48713,0.000023,0.001338,0.001361
10,15,25,61720,8129090,8190810,0.002287,0.145266,0.147553
10,14,24,10394,287186,297580,0.000484,0.005193,0.005677
10,14,24,34751,1264338,1299089,0.001459,0.028884,0.030343
10,14,24,22328,272652,294980,0.001259,0.006881,0.008140
10,14,24,75610,502534,578144,0.002720,0.010968,0.013688
10,14,24,19220,68477,87697,0.000926,0.001760,0.002686
10,13,23,16515,95271,111786,0.000738,0.002441,0.003179
9,15,24,3565,2484338,2487903,0.000185,0.049468,0.049653
10,15,25,28580,1496115,1524695,0.001215,0.028003,0.029218
10,14,24,45065,921275,966340,0.001803,0.017099,0.018902
9,14,23,7979,2565779,2573758,0.000360,0.041873,0.042233
9,14,23,24406,939166,963572,0.000824,0.015859,0.016683
10,15,25,18683,979466,998149,0.001307,0.018740,0.020047
9,14,23,1383,1511563,1512946,0.000076,0.027763,0.027839
9,14,23,2688,181825,184513,0.000148,0.003602,0.003750
10,14,24,35856,482510,518366,0.001923,0.009381,0.011304
10,12,22,20650,21442,42092,0.000870,0.000445,0.001315
10,14,24,10282,916619,926901,0.000434,0.016743,0.017177
10,16,26,31310,3944053,3975363,0.001324,0.075368,0.076692
9,15,24,4999,339539,344538,0.000277,0.008800,0.009077
10,12,22,61816,6117,67933,0.003964,0.000238,0.004202
10,14,24,11712,49138,60850,0.000554,0.001337,0.001891
10,12,22,12191,7131,19322,0.000534,0.000189,0.000723
10,14,24,31449,193905,225354,0.001193,0.005472,0.006665
9,15,24,11998,332605,344603,0.000598,0.010787,0.011385
9,14,23,703,157371,158074,0.000043,0.003830,0.003873
9,12,21,6731,4872,11603,0.000361,0.000132,0.000493
10,11,21,19563,6578,26141,0.000945,0.000160,0.001105
9,14,23,6722,841798,848520,0.000291,0.019791,0.020082
9,14,23,3574,436106,439680,0.000191,0.010147,0.010338
9,14,23,5311,309182,314493,0.000271,0.006642,0.006913
7,14,21,250,509313,509563,0.000011,0.009035,0.009046
10,15,25,14270,1133202,1147472,0.000651,0.021069,0.021720
11,12,23,88656,87824,176480,0.003278,0.001676,0.004954
9,14,23,13500,352705,366205,0.000424,0.007209,0.007633
10,13,23,34084,259018,293102,0.001402,0.005118,0.006520
10,12,22,17715,21343,39058,0.000676,0.000434,0.001110
10,15,25,22376,2847420,2869796,0.000871,0.053350,0.054221
10,14,24,41167,381696,422863,0.001771,0.007719,0.009490
10,14,24,9697,533997,543694,0.000454,0.009852,0.010306
10,13,23,5716,58996,64712,0.000283,0.001247,0.001530
10,14,24,27887,209331,237218,0.001155,0.003722,0.004877
10,14,24,14236,530564,544800,0.000583,0.011228,0.011811
10,15,25,28251,287794,316045,0.001301,0.007149,0.008450
9,14,23,2897,513400,516297,0.000152,0.012158,0.012310
9,15,24,2387,1840335,1842722,0.000145,0.044106,0.044251
10,14,24,17899,270552,288451,0.000969,0.007267,0.008236
9,14,23,10862,95651,106513,0.000582,0.002665,0.003247
10,15,25,14182,350223,364405,0.000680,0.009964,0.010644
10,15,25,52283,558089,610372,0.002650,0.016212,0.018862
11,14,25,76843,430911,507754,0.003872,0.011951,0.015823
10,14,24,24012,1137070,1161082,0.001224,0.031158,0.032382
10,16,26,47937,2479994,2527931,0.002401,0.055401,0.057802
10,15,25,7256,882820,890076,0.000399,0.015682,0.016081
9,16,25,2533,3587804,3590337,0.000123,0.066521,0.066644
9,15,24,8768,440631,449399,0.000427,0.008160,0.008587
10,14,24,8582,239393,247975,0.000409,0.004692,0.005101
8,13,21,776,105095,105871,0.000040,0.001937,0.001977
10,15,25,33084,2543237,2576321,0.001515,0.047384,0.048899
10,14,24,6089,205101,211190,0.000317,0.004173,0.004490
9,13,22,6481,45370,51851,0.000323,0.000997,0.001320
9,13,22,4934,252504,257438,0.000239,0.004877,0.005116
11,15,26,391405,2425708,2817113,0.010168,0.051917,0.062085
10,13,23,25928,221133,247061,0.001142,0.006031,0.007173
9,16,25,4287,3292283,3296570,0.000394,0.061295,0.061689
10,14,24,36229,560274,596503,0.001552,0.010851,0.012403
10,15,25,39893,1487169,1527062,0.001542,0.027930,0.029472
10,13,23,35694,413348,449042,0.001426,0.007609,0.009035
9,15,24,3894,1889820,1893714,0.000179,0.038419,0.038598
9,13,22,3599,503479,507078,0.000177,0.009124,0.009301
10,14,24,4714,256260,260974,0.000226,0.004745,0.004971
10,16,26,41991,4070052,4112043,0.001678,0.087361,0.089039
10,13,23,59481,90601,150082,0.002693,0.002325,0.005018
10,14,24,12989,837058,850047,0.000556,0.020662,0.021218
9,13,22,3214,31561,34775,0.000195,0.000803,0.000998
9,15,24,1505,4574069,4575574,0.000079,0.100542,0.100621
9,16,25,15470,6145491,6160961,0.000926,0.141194,0.142120
10,15,25,7779,7148947,7156726,0.000404,0.140607,0.141011
9,13,22,2952,279196,282148,0.000150,0.004804,0.004954
10,15,25,20868,384246,405114,0.000882,0.007209,0.008091
10,13,23,9379,344441,353820,0.000410,0.005791,0.006201
10,11,21,18617,292,18909,0.000735,0.000010,0.000745
10,15,25,35792,878806,914598,0.001374,0.019106,0.020480
9,13,22,6780,245817,252597,0.000324,0.005651,0.005975
9,13,22,2158,137779,139937,0.000107,0.003061,0.003168
10,14,24,27858,84783,112641,0.001239,0.002047,0.003286
9,14,23,2956,916884,919840,0.000139,0.019609,0.019748
10,16,26,17996,5349710,5367706,0.000814,0.098467,0.099281
9,14,23,2826,131920,134746,0.000149,0.002363,0.002512
10,15,25,31050,1902957,1934007,0.001188,0.032988,0.034176
9,16,25,2244,5733840,5736084,0.000106,0.095193,0.095299
9,13,22,5993,52097,58090,0.000302,0.001000,0.001302
10,14,24,9178,184136,193314,0.000429,0.003291,0.003720
9,15,24,4901,876333,881234,0.000226,0.022956,0.023182
9,14,23,15609,64901,80510,0.001245,0.001443,0.002688
9,14,23,5781,96567,102348,0.000245,0.002002,0.002247
10,14,24,16435,1890703,1907138,0.000694,0.033803,0.034497
11,15,26,64737,319767,384504,0.002511,0.007049,0.009560
11,15,26,85432,3187158,3272590,0.003384,0.068302,0.071686
9,11,20,5731,7204,12935,0.000300,0.000135,0.000435
9,13,22,3093,219159,222252,0.000157,0.004119,0.004276
9,14,23,1661,154572,156233,0.000083,0.002898,0.002981
8,15,23,623,2931004,2931627,0.000028,0.050123,0.050151
10,14,24,21243,4093729,4114972,0.000846,0.067607,0.068453
9,15,24,10409,2685688,2696097,0.000452,0.045595,0.046047
10,14,24,12297,535941,548238,0.000525,0.010293,0.010818
8,14,22,574,193396,193970,0.000027,0.003556,0.003583
8,16,24,1385,1927024,1928409,0.000062,0.033270,0.033332
10,13,23,48364,181159,229523,0.001875,0.003445,0.005320
10,13,23,61185,444946,506131,0.002106,0.008549,0.010655
10,14,24,63426,589213,652639,0.002431,0.013410,0.015841
9,16,25,3960,3778035,3781995,0.000179,0.071084,0.071263
9,14,23,2358,2015493,2017851,0.000115,0.035413,0.035528
10,15,25,30813,1013551,1044364,0.001333,0.018014,0.019347
10,15,25,14045,767920,781965,0.000581,0.013291,0.013872
10,14,24,83625,1155811,1239436,0.003061,0.023808,0.026869
10,14,24,40557,484413,524970,0.001570,0.010351,0.011921
9,15,24,2445,2419312,2421757,0.000115,0.044189,0.044304
8,14,22,660,215520,216180,0.000029,0.003752,0.003781
8,14,22,803,1375149,1375952,0.000036,0.023210,0.023246
9,14,23,7645,67485,75130,0.000350,0.001199,0.001549
10,15,25,26610,611406,638016,0.001061,0.010938,0.011999
10,12,22,29757,40873,70630,0.001243,0.000846,0.002089
9,14,23,4108,58184,62292,0.000157,0.001399,0.001556
9,14,23,5413,324613,330026,0.000222,0.006274,0.006496
9,15,24,4992,953885,958877,0.000212,0.019694,0.019906
10,15,25,122966,1268042,1391008,0.004131,0.027313,0.031444
10,13,23,17759,112478,130237,0.000781,0.002659,0.003440
10,14,24,16219,494822,511041,0.000762,0.010991,0.011753
10,14,24,22444,3283736,3306180,0.001057,0.058262,0.059319
9,12,21,7798,76720,84518,0.000339,0.001356,0.001695
9,14,23,13293,243885,257178,0.000435,0.004509,0.004944
10,14,24,44153,204866,249019,0.001771,0.003662,0.005433
10,15,25,24087,6602488,6626575,0.000853,0.112592,0.113445
10,13,23,39777,6945,46722,0.001446,0.000171,0.001617
10,14,24,23814,649698,673512,0.000916,0.011575,0.012491
10,14,24,9776,360981,370757,0.000399,0.007116,0.007515
10,13,23,62808,109917,172725,0.002263,0.002164,0.004427
10,14,24,11137,93526,104663,0.000447,0.002074,0.002521
9,13,22,2634,63140,65774,0.000115,0.001367,0.001482
10,15,25,6374,3391987,3398361,0.000295,0.070433,0.070728
10,12,22,16964,65376,82340,0.001340,0.002225,0.003565
10,14,24,30234,351353,381587,0.001288,0.007298,0.008586
9,14,23,985,643684,644669,0.000046,0.014677,0.014723
9,14,23,13574,66306,79880,0.000683,0.001701,0.002384
10,15,25,17120,1869727,1886847,0.000847,0.040622,0.041469
9,14,23,2730,100771,103501,0.000136,0.002146,0.002282
10,13,23,15084,321903,336987,0.000700,0.005979,0.006679
8,13,21,770,384083,384853,0.000036,0.007412,0.007448
9,14,23,10079,329499,339578,0.000443,0.006321,0.006764
9,12,21,1433,111636,113069,0.000072,0.002074,0.002146
9,16,25,4255,963516,967771,0.000198,0.019127,0.019325
10,14,24,4473,552868,557341,0.000225,0.010386,0.010611
9,15,24,8643,4218126,4226769,0.000346,0.076538,0.076884
8,14,22,479,309370,309849,0.000023,0.005475,0.005498
10,14,24,46303,143196,189499,0.001661,0.002765,0.004426
10,13,23,42177,73113,115290,0.001558,0.001389,0.002947
10,12,22,16491,5727,22218,0.000609,0.000129,0.000738
10,14,24,36643,314654,351297,0.001347,0.006993,0.008340
9,13,22,11987,966629,978616,0.000488,0.020650,0.021138
9,15,24,5346,719262,724608,0.000269,0.014819,0.015088
10,15,25,63485,1290780,1354265,0.002410,0.026347,0.028757
11,16,27,112539,2424297,2536836,0.003791,0.051365,0.055156
10,13,23,35360,157311,192671,0.001472,0.003128,0.004600
10,13,23,38399,22382,60781,0.001391,0.000585,0.001976
8,14,22,856,40451,41307,0.000036,0.001071,0.001107
9,13,22,5039,26530,31569,0.000225,0.000567,0.000792
10,15,25,6429,3955937,3962366,0.000269,0.073723,0.073992
9,15,24,1831,3857441,3859272,0.000087,0.066736,0.066823
9,15,24,11867,4141926,4153793,0.000531,0.071861,0.072392
9,14,23,2302,222948,225250,0.000121,0.004167,0.004288
9,11,20,542,2012,2554,0.000026,0.000046,0.000072
10,14,24,36967,42939,79906,0.001546,0.001028,0.002574
10,13,23,53168,414854,468022,0.001859,0.008434,0.010293
10,15,25,22761,390648,413409,0.001021,0.010164,0.011185
10,14,24,33681,1164133,1197814,0.001544,0.026614,0.028158
10,15,25,66214,802030,868244,0.002801,0.018778,0.021579
9,15,24,4787,834587,839374,0.000245,0.018242,0.018487
10,14,24,34603,564625,599228,0.001377,0.011290,0.012667
10,14,24,11758,211440,223198,0.000531,0.005074,0.005605
10,12,22,23773,61598,85371,0.001099,0.001484,0.002583
9,13,22,5531,120600,126131,0.000229,0.002712,0.002941
10,14,24,11790,1051704,1063494,0.000517,0.023771,0.024288
10,13,23,16945,300488,317433,0.000762,0.006704,0.007466
9,13,22,6693,969972,976665,0.000313,0.018478,0.018791
8,13,21,2126,63325,65451,0.000093,0.001207,0.001300
10,14,24,13288,1435142,1448430,0.000540,0.024818,0.025358
9,15,24,1293,1507271,1508564,0.000059,0.026173,0.026232
10,14,24,63630,21389,85019,0.002424,0.000626,0.003050
9,16,25,7380,5137578,5144958,0.000247,0.093925,0.094172
9,13,22,6624,2867,9491,0.000292,0.000071,0.000363
11,12,23,109703,26866,136569,0.003995,0.000613,0.004608
10,14,24,18736,402239,420975,0.000605,0.009300,0.009905
10,15,25,70790,2952937,3023727,0.002809,0.061146,0.063955
10,16,26,31224,2923383,2954607,0.001302,0.061070,0.062372
9,15,24,3247,1343083,1346330,0.000169,0.024079,0.024248
9,15,24,20579,1318210,1338789,0.000870,0.024855,0.025725
10,15,25,58499,621568,680067,0.002408,0.013099,0.015507
10,12,22,24757,101047,125804,0.001040,0.002103,0.003143
10,15,25,55214,3057516,3112730,0.002357,0.060111,0.062468
10,15,25,35646,3804971,3840617,0.001477,0.064995,0.066472
9,15,24,4132,783033,787165,0.000215,0.013978,0.014193
9,13,22,1591,55661,57252,0.000082,0.001000,0.001082
10,16,26,7986,2037545,2045531,0.000408,0.036206,0.036614
10,15,25,58947,1285360,1344307,0.002250,0.023543,0.025793
9,12,21,10458,8247,18705,0.000448,0.000157,0.000605
10,13,23,86829,67433,154262,0.002857,0.001559,0.004416
10,13,23,9371,90667,100038,0.000378,0.001938,0.002316
10,13,23,13878,41238,55116,0.000528,0.001095,0.001623
9,13,22,1207,74213,75420,0.000054,0.001675,0.001729
10,13,23,14975,150746,165721,0.000632,0.003611,0.004243
9,15,24,7016,1219882,1226898,0.000311,0.030081,0.030392
10,14,24,33592,586374,619966,0.001442,0.013387,0.014829
11,13,24,119382,53790,173172,0.004523,0.001355,0.005878
9,14,23,1725,23816,25541,0.000076,0.000827,0.000903
9,13,22,4482,361572,366054,0.000194,0.008537,0.008731
9,13,22,16442,512132,528574,0.000566,0.011723,0.012289
10,13,23,73785,890048,963833,0.002870,0.019700,0.022570
9,14,23,7575,114516,122091,0.000356,0.002713,0.003069
9,15,24,1858,2368285,2370143,0.000084,0.047604,0.047688
9,13,22,3323,46237,49560,0.000146,0.000921,0.001067
10,14,24,19092,189412,208504,0.000782,0.003731,0.004513
9,16,25,4378,4789690,4794068,0.000197,0.082869,0.083066
10,13,23,14377,795331,809708,0.000584,0.013608,0.014192
10,14,24,19111,57640,76751,0.000828,0.001078,0.001906
8,13,21,520,11900,12420,0.000019,0.000233,0.000252
9,13,22,25509,448285,473794,0.000946,0.008033,0.008979
9,13,22,2484,12956,15440,0.000114,0.000265,0.000379
9,13,22,7457,6050,13507,0.000310,0.000132,0.000442
10,13,23,40740,81262,122002,0.001431,0.001854,0.003285
10,15,25,22654,852429,875083,0.000832,0.019551,0.020383
10,14,24,28757,100348,129105,0.001239,0.002346,0.003585
10,15,25,25709,2517802,2543511,0.001078,0.049130,0.050208
10,15,25,9300,922570,931870,0.000401,0.016446,0.016847
9,15,24,1531,593148,594679,0.000073,0.011174,0.011247
9,15,24,5682,2575460,2581142,0.000284,0.045357,0.045641
9,14,23,12983,208227,221210,0.000538,0.003862,0.004400
9,15,24,4574,364493,369067,0.000212,0.006418,0.006630
9,13,22,8373,56524,64897,0.000366,0.000959,0.001325
9,14,23,2832,691373,694205,0.000139,0.012075,0.012214
10,14,24,9893,182066,191959,0.000443,0.003299,0.003742
9,14,23,5082,244786,249868,0.000206,0.004313,0.004519
10,10,20,23083,251,23334,0.000951,0.000010,0.000961
10,15,25,27927,414890,442817,0.000990,0.008262,0.009252
10,15,25,85308,641043,726351,0.003249,0.014911,0.018160
10,14,24,68544,320052,388596,0.002726,0.007788,0.010514
8,15,23,1070,4165723,4166793,0.000040,0.080786,0.080826
10,14,24,11961,56284,68245,0.000541,0.001138,0.001679
9,15,24,5830,344015,349845,0.000254,0.007350,0.007604
8,15,23,870,406335,407205,0.000046,0.008343,0.008389
9,15,24,4082,15991985,15996067,0.000202,0.292260,0.292462
9,15,24,765,582902,583667,0.000042,0.012764,0.012806
9,13,22,658,42164,42822,0.000038,0.000843,0.000881
10,15,25,26699,3985819,4012518,0.001123,0.071572,0.072695
9,15,24,4248,9126111,9130359,0.000210,0.160185,0.160395
10,15,25,46773,1594356,1641129,0.002019,0.041285,0.043304
10,15,25,23115,486889,510004,0.001088,0.011500,0.012588
9,13,22,1049,92492,93541,0.000054,0.002169,0.002223
8,14,22,2288,829716,832004,0.000112,0.018965,0.019077
10,14,24,11748,97758,109506,0.000541,0.002670,0.003211
11,13,24,142130,76832,218962,0.005308,0.001949,0.007257
9,13,22,3455,8933,12388,0.000142,0.000231,0.000373
10,15,25,26466,538978,565444,0.000939,0.012843,0.013782
9,13,22,4329,215452,219781,0.000202,0.004985,0.005187
10,14,24,27892,1002790,1030682,0.001284,0.020611,0.021895
10,15,25,29536,2363307,2392843,0.001268,0.046091,0.047359
10,14,24,3479,823784,827263,0.000177,0.014600,0.014777
10,14,24,5229,20944,26173,0.000250,0.000509,0.000759
9,14,23,2834,38019,40853,0.000140,0.000736,0.000876
11,16,27,87739,3906573,3994312,0.003100,0.073949,0.077049
9,15,24,3248,2952485,2955733,0.000145,0.054289,0.054434
8,14,22,321,67232,67553,0.000018,0.001293,0.001311
10,13,23,24318,161322,185640,0.001035,0.002887,0.003922
10,13,23,39343,214319,253662,0.001495,0.004079,0.005574
9,13,22,4444,1118890,1123334,0.000197,0.022299,0.022496
10,12,22,34804,23690,58494,0.001324,0.000464,0.001788
10,16,26,20056,5126810,5146866,0.000791,0.090696,0.091487
8,14,22,690,1164123,1164813,0.000072,0.022010,0.022082
9,14,23,728,1310852,1311580,0.000076,0.022426,0.022502
10,16,26,21935,5710934,5732869,0.000946,0.115091,0.116037
10,15,25,30996,29639493,29670489,0.001235,0.563760,0.564995
9,15,24,2015,1095785,1097800,0.000112,0.020914,0.021026
10,13,23,21068,29509,50577,0.000942,0.000613,0.001555
10,15,25,42096,3378000,3420096,0.001441,0.062384,0.063825
9,14,23,5446,134961,140407,0.000288,0.002790,0.003078
9,16,25,9567,6868255,6877822,0.000452,0.118436,0.118888
9,15,24,4565,1077577,1082142,0.000215,0.019237,0.019452
10,15,25,30138,2868752,2898890,0.001215,0.050618,0.051833
7,15,22,294,233593,233887,0.000016,0.004472,0.004488
9,15,24,19977,1703995,1723972,0.000788,0.031115,0.031903
9,15,24,5049,433107,438156,0.000261,0.007952,0.008213
9,15,24,5894,374613,380507,0.000269,0.006804,0.007073
10,13,23,23187,43105,66292,0.000977,0.000898,0.001875
10,16,26,34814,2407342,2442156,0.001314,0.056322,0.057636
10,14,24,27882,2989495,3017377,0.001205,0.055623,0.056828
8,15,23,390,1785174,1785564,0.000024,0.041737,0.041761
10,15,25,14313,353655,367968,0.000783,0.008990,0.009773
10,13,23,13753,53947,67700,0.000712,0.001431,0.002143
10,13,23,9607,46033,55640,0.000499,0.001135,0.001634
11,15,26,121950,1053291,1175241,0.004796,0.026248,0.031044
9,15,24,1392,643297,644689,0.000083,0.014836,0.014919
9,13,22,5312,60565,65877,0.000297,0.001536,0.001833
10,13,23,11554,541304,552858,0.000544,0.011671,0.012215
9,15,24,7274,244983,252257,0.000345,0.005393,0.005738
9,12,21,8486,225329,233815,0.000387,0.004799,0.005186
8,13,21,590,303590,304180,0.000031,0.007045,0.007076
10,15,25,13545,527400,540945,0.000708,0.012079,0.012787
9,13,22,3064,304005,307069,0.000174,0.006660,0.006834
10,14,24,26456,129094,155550,0.001208,0.003096,0.004304
11,15,26,117301,905308,1022609,0.004542,0.020967,0.025509
9,14,23,4889,802327,807216,0.000242,0.017954,0.018196
10,15,25,33538,552270,585808,0.001433,0.012719,0.014152
10,14,24,41299,250481,291780,0.001842,0.005879,0.007721
10,13,23,5800,374241,380041,0.000305,0.008548,0.008853
9,14,23,8834,179009,187843,0.000432,0.004259,0.004691
10,14,24,7564,673510,681074,0.000368,0.014630,0.014998
9,14,23,6686,186822,193508,0.000340,0.004466,0.004806
8,14,22,372,131738,132110,0.000020,0.003087,0.003107
9,15,24,4006,858414,862420,0.000233,0.020432,0.020665
10,13,23,11033,22814,33847,0.000604,0.000650,0.001254
10,16,26,15217,1776715,1791932,0.000792,0.043990,0.044782
10,15,25,12343,472168,484511,0.000644,0.010941,0.011585
10,14,24,12977,161161,174138,0.000676,0.003817,0.004493
10,15,25,23855,1275558,1299413,0.001171,0.029061,0.030232
10,15,25,64296,1133676,1197972,0.002883,0.025918,0.028801
10,13,23,23641,552338,575979,0.001153,0.012386,0.013539
10,14,24,15832,141394,157226,0.000814,0.003465,0.004279
9,12,21,7607,2286,9893,0.000390,0.000090,0.000480
10,14,24,35650,83428,119078,0.001584,0.002321,0.003905
10,14,24,22945,208711,231656,0.001038,0.005346,0.006384
10,15,25,26073,3062839,3088912,0.001208,0.062015,0.063223
10,14,24,11300,1034433,1045733,0.000528,0.017904,0.018432
10,13,23,36841,183932,220773,0.001500,0.003393,0.004893
10,14,24,26421,1390367,1416788,0.000993,0.026605,0.027598
10,14,24,35138,813448,848586,0.001432,0.013946,0.015378
10,15,25,23968,869378,893346,0.000898,0.015292,0.016190
10,15,25,11875,1707506,1719381,0.000451,0.033212,0.033663
9,15,24,3870,1460647,1464517,0.000201,0.025647,0.025848
9,13,22,5492,15745,21237,0.000253,0.000301,0.000554
9,14,23,5249,118767,124016,0.000253,0.002121,0.002374
10,14,24,100406,144927,245333,0.003286,0.002986,0.006272
10,12,22,16848,21192,38040,0.000705,0.000493,0.001198
9,12,21,5420,36724,42144,0.000220,0.000785,0.001005
10,14,24,6846,44309,51155,0.000284,0.001113,0.001397
9,15,24,3119,2130270,2133389,0.000136,0.043558,0.043694
10,15,25,44457,294029,338486,0.001698,0.005719,0.007417
9,15,24,12163,2096265,2108428,0.000475,0.041749,0.042224
8,14,22,535,1687123,1687658,0.000025,0.029069,0.029094
8,14,22,1567,84050,85617,0.000077,0.001548,0.001625
9,11,20,1894,36088,37982,0.000090,0.000570,0.000660
9,14,23,6732,131153,137885,0.000326,0.002346,0.002672
9,13,22,3111,351192,354303,0.000150,0.005827,0.005977
10,15,25,74408,173079,247487,0.002670,0.003481,0.006151
9,14,23,19241,1195001,1214242,0.000703,0.024060,0.024763
9,14,23,3535,156601,160136,0.000142,0.002802,0.002944
10,15,25,19475,1721032,1740507,0.000819,0.030564,0.031383
10,13,23,28693,201677,230370,0.001123,0.003485,0.004608
10,13,23,28245,215695,243940,0.000982,0.004009,0.004991
9,12,21,1681,6105,7786,0.000069,0.000164,0.000233
10,13,23,14266,58508,72774,0.000589,0.001285,0.001874
9,14,23,3323,804833,808156,0.000169,0.016962,0.017131
9,14,23,6307,538476,544783,0.000274,0.009454,0.009728
10,15,25,33553,2093563,2127116,0.001324,0.045048,0.046372
10,14,24,64475,560368,624843,0.003104,0.011364,0.014468
9,14,23,11116,495823,506939,0.000477,0.009190,0.009667
9,14,23,4131,227515,231646,0.000194,0.003567,0.003761
10,13,23,17309,376185,393494,0.000691,0.006454,0.007145
10,15,25,46298,1108462,1154760,0.001771,0.024595,0.026366
8,13,21,294,318069,318363,0.000013,0.005915,0.005928
10,14,24,15665,105687,121352,0.000679,0.001888,0.002567
10,13,23,35637,469186,504823,0.001334,0.009029,0.010363
9,13,22,8043,61485,69528,0.000359,0.001516,0.001875
9,13,22,2902,83758,86660,0.000137,0.001946,0.002083
8,14,22,575,372450,373025,0.000027,0.008414,0.008441
10,14,24,18484,294856,313340,0.000762,0.006573,0.007335
9,14,23,18293,208665,226958,0.000745,0.004493,0.005238
10,12,22,15910,22065,37975,0.000737,0.000540,0.001277
10,12,22,30039,25895,55934,0.001205,0.000651,0.001856
8,14,22,1134,947182,948316,0.000055,0.020841,0.020896
10,15,25,19627,1459856,1479483,0.000840,0.028477,0.029317
10,14,24,19445,1197753,1217198,0.000773,0.021329,0.022102
9,14,23,13642,449791,463433,0.000600,0.007955,0.008555
8,14,22,325,144225,144550,0.000013,0.002510,0.002523
10,14,24,10584,1606949,1617533,0.000470,0.026868,0.027338
10,15,25,18855,2408631,2427486,0.000770,0.041556,0.042326
9,14,23,2886,105253,108139,0.000135,0.001869,0.002004
10,15,25,49760,1033561,1083321,0.001645,0.017746,0.019391
9,15,24,851,2422814,2423665,0.000038,0.044900,0.044938
9,15,24,7427,1211533,1218960,0.000348,0.020693,0.021041
10,15,25,21108,395628,416736,0.000825,0.007451,0.008276
9,14,23,2673,128837,131510,0.000117,0.002233,0.002350
10,14,24,8028,733903,741931,0.000357,0.012765,0.013122
10,15,25,24486,2933608,2958094,0.001025,0.049658,0.050683
10,15,25,12069,1284849,1296918,0.000516,0.022684,0.023200
9,15,24,3173,2386702,2389875,0.000346,0.040421,0.040767
10,15,25,63543,3842294,3905837,0.002489,0.066817,0.069306
9,14,23,15865,307583,323448,0.000695,0.005518,0.006213
9,15,24,3708,638628,642336,0.000169,0.010997,0.011166
10,13,23,26927,34791,61718,0.001126,0.000604,0.001730
9,14,23,2502,460546,463048,0.000110,0.008218,0.008328
11,15,26,87315,403977,491292,0.003013,0.008618,0.011631
9,14,23,1750,711067,712817,0.000082,0.015930,0.016012
9,10,19,6510,1037,7547,0.000311,0.000036,0.000347
10,12,22,44996,135184,180180,0.001899,0.002968,0.004867
9,14,23,2627,57124,59751,0.000124,0.001380,0.001504
9,12,21,4294,37791,42085,0.000177,0.000988,0.001165
9,14,23,2777,260344,263121,0.000132,0.005962,0.006094
10,15,25,38583,2741755,2780338,0.001524,0.053786,0.055310
8,15,23,939,2868869,2869808,0.000040,0.048381,0.048421
10,15,25,34324,192287,226611,0.001380,0.003554,0.004934
10,14,24,34663,488085,522748,0.001180,0.008688,0.009868
9,8,17,6473,103,6576,0.000233,0.000002,0.000235
10,12,22,19073,46127,65200,0.000717,0.000996,0.001713
10,14,24,61435,173842,235277,0.002123,0.003923,0.006046
10,15,25,54732,1026145,1080877,0.002086,0.024382,0.026468
10,12,22,12282,4202,16484,0.000538,0.000117,0.000655
10,14,24,33713,426254,459967,0.001429,0.009537,0.010966
9,15,24,5453,2929310,2934763,0.000275,0.058181,0.058456
10,15,25,26389,1163322,1189711,0.001169,0.019595,0.020764
10,13,23,6793,205651,212444,0.000322,0.003685,0.004007
10,15,25,30092,8004617,8034709,0.001136,0.151359,0.152495
9,15,24,3516,2663609,2667125,0.000177,0.050320,0.050497
10,15,25,11583,1600648,1612231,0.000563,0.028858,0.029421
9,14,23,4186,1025912,1030098,0.000201,0.018026,0.018227
9,14,23,1433,658902,660335,0.000071,0.011680,0.011751
8,15,23,1999,2278310,2280309,0.000092,0.038995,0.039087
10,14,24,25331,116937,142268,0.001074,0.002111,0.003185
9,14,23,7999,435182,443181,0.000313,0.007584,0.007897
7,15,22,216,5266026,5266242,0.000007,0.089121,0.089128
10,16,26,13589,4573093,4586682,0.000583,0.077065,0.077648
9,15,24,3787,1288663,1292450,0.000188,0.022040,0.022228
10,13,23,18322,24093,42415,0.000710,0.000498,0.001208
10,14,24,24517,837716,862233,0.000905,0.014358,0.015263
8,13,21,500,149671,150171,0.000018,0.002662,0.002680
7,14,21,283,183936,184219,0.000011,0.003271,0.003282
10,16,26,19483,3767429,3786912,0.000817,0.065555,0.066372
9,15,24,1428,1601607,1603035,0.000067,0.027349,0.027416
10,13,23,40523,148449,188972,0.001648,0.002727,0.004375
7,15,22,217,2545612,2545829,0.000007,0.043601,0.043608
9,14,23,5492,893927,899419,0.000246,0.014743,0.014989
8,15,23,1817,981050,982867,0.000067,0.018099,0.018166
9,16,25,6673,4764456,4771129,0.000298,0.081731,0.082029
10,14,24,48369,59317,107686,0.001920,0.001091,0.003011
10,14,24,21368,264596,285964,0.000762,0.005067,0.005829
9,14,23,5056,269189,274245,0.000206,0.004900,0.005106
8,14,22,526,146186,146712,0.000021,0.002884,0.002905
10,15,25,20066,1828750,1848816,0.000811,0.033688,0.034499
11,16,27,151845,17104703,17256548,0.005173,0.293339,0.298512
10,14,24,11822,416780,428602,0.000569,0.008197,0.008766
10,15,25,32667,882579,915246,0.001325,0.018156,0.019481
8,16,24,626,1709484,1710110,0.000032,0.032652,0.032684
10,14,24,10312,618371,628683,0.000471,0.011597,0.012068
9,14,23,4837,254718,259555,0.000231,0.004707,0.004938
9,16,25,29388,1700500,1729888,0.001065,0.032391,0.033456
10,13,23,42325,1548,43873,0.001781,0.000054,0.001835
9,14,23,1113,724113,725226,0.000044,0.013583,0.013627
9,14,23,20055,394083,414138,0.000774,0.007433,0.008207
10,13,23,16495,88149,104644,0.000679,0.001856,0.002535
9,15,24,6279,206827,213106,0.000260,0.004625,0.004885
9,15,24,3188,3327157,3330345,0.000138,0.058862,0.059000
10,15,25,32519,404232,436751,0.001300,0.007093,0.008393
9,15,24,6509,399264,405773,0.000292,0.007210,0.007502
9,15,24,955,3980123,3981078,0.000041,0.067381,0.067422
10,15,25,48131,8115931,8164062,0.001949,0.142708,0.144657
8,15,23,325,2045223,2045548,0.000016,0.036403,0.036419
