phase1_solution_length,phase2_solution_length,solution_length,phase1_move_count,phase2_move_count,move_count,phase1_solve_time,phase2_solve_time,solve_time
9,16,25,1800,5383076,5384876,0.000112,0.148653,0.148765
9,14,23,2212,190310,192522,0.000147,0.004858,0.005005
8,15,23,496,2563669,2564165,0.000029,0.063356,0.063385
10,14,24,10144,420988,431132,0.000530,0.010363,0.010893
9,16,25,7188,7585647,7592835,0.000375,0.165152,0.165527
9,15,24,6123,433510,439633,0.000291,0.009792,0.010083
9,14,23,3364,599143,602507,0.000164,0.010765,0.010929
9,15,24,8745,1674082,1682827,0.000389,0.029050,0.029439
10,13,23,17975,23967,41942,0.000740,0.000530,0.001270
10,13,23,35758,46397,82155,0.001343,0.000935,0.002278
10,14,24,51175,4738818,4789993,0.001712,0.096965,0.098677
9,14,23,4705,245095,249800,0.000226,0.004648,0.004874
10,14,24,29344,209830,239174,0.001222,0.008298,0.009520
8,15,23,888,3341016,3341904,0.000051,0.078143,0.078194
10,14,24,77427,254859,332286,0.003524,0.006390,0.009914
9,13,22,7480,25795,33275,0.000346,0.000802,0.001148
10,15,25,53471,672636,726107,0.002278,0.016830,0.019108
10,14,24,14470,1177494,1191964,0.000663,0.025941,0.026604
10,15,25,63587,430106,493693,0.002616,0.010794,0.013410
9,12,21,10404,21684,32088,0.000514,0.000590,0.001104
9,12,21,4306,41241,45547,0.000211,0.001099,0.001310
10,16,26,77063,3845086,3922149,0.003243,0.088612,0.091855
9,11,20,9396,26421,35817,0.000431,0.000516,0.000947
8,15,23,796,1157460,1158256,0.000036,0.022582,0.022618
10,14,24,9916,269044,278960,0.000444,0.005292,0.005736
9,15,24,7886,4739466,4747352,0.000343,0.097549,0.097892
9,15,24,741,1080527,1081268,0.000040,0.029279,0.029319
9,15,24,8176,1113412,1121588,0.000444,0.027778,0.028222
8,14,22,1658,599254,600912,0.000096,0.013743,0.013839
8,13,21,1731,434967,436698,0.000095,0.009981,0.010076
10,15,25,16227,364854,381081,0.000828,0.007979,0.008807
8,13,21,3342,114765,118107,0.000153,0.002686,0.002839
9,13,22,10628,75706,86334,0.000476,0.001747,0.002223
10,15,25,35162,1871288,1906450,0.001550,0.040738,0.042288
9,13,22,6410,78411,84821,0.000279,0.001520,0.001799
10,14,24,45919,1414920,1460839,0.001785,0.028224,0.030009
10,16,26,5056,2875155,2880211,0.000211,0.056726,0.056937
8,13,21,392,62428,62820,0.000021,0.001580,0.001601
10,16,26,12003,3098826,3110829,0.000629,0.062730,0.063359
10,13,23,16254,695,16949,0.000715,0.000028,0.000743
9,16,25,10752,1745904,1756656,0.000423,0.032269,0.032692
9,13,22,2628,197483,200111,0.000112,0.003565,0.003677
10,15,25,8452,2663319,2671771,0.000370,0.048595,0.048965
9,15,24,1981,1297368,1299349,0.000096,0.022936,0.023032
10,12,22,23487,16758,40245,0.000976,0.000322,0.001298
10,14,24,31816,493535,525351,0.001206,0.010040,0.011246
10,14,24,15546,864630,880176,0.000681,0.019005,0.019686
9,15,24,16244,3463433,3479677,0.000686,0.077342,0.078028
10,15,25,9162,415483,424645,0.000429,0.007887,0.008316
9,14,23,7885,213738,221623,0.000357,0.004202,0.004559
9,14,23,3842,1311969,1315811,0.000176,0.023940,0.024116
8,14,22,1136,1904046,1905182,0.000048,0.034221,0.034269
9,15,24,5202,761543,766745,0.000248,0.014211,0.014459
9,12,21,8319,68096,76415,0.000391,0.001400,0.001791
9,14,23,2260,170438,172698,0.000107,0.003100,0.003207
10,14,24,7993,699660,707653,0.000353,0.012539,0.012892
10,14,24,7862,516781,524643,0.000347,0.009676,0.010023
9,15,24,1660,3007888,3009548,0.000328,0.065343,0.065671
9,14,23,29222,352836,382058,0.001424,0.007721,0.009145
9,14,23,7050,167783,174833,0.000306,0.003367,0.003673
10,13,23,12653,214262,226915,0.000538,0.004473,0.005011
9,14,23,3396,221348,224744,0.000142,0.005088,0.005230
10,13,23,24232,4738,28970,0.001127,0.000140,0.001267
8,15,23,689,251287,251976,0.000032,0.005728,0.005760
10,16,26,73608,1402345,1475953,0.002767,0.033431,0.036198
10,15,25,23365,1547221,1570586,0.001145,0.034231,0.035376
10,14,24,13045,248189,261234,0.000602,0.005366,0.005968
10,15,25,6856,2293550,2300406,0.000342,0.044850,0.045192
9,14,23,2390,4065203,4067593,0.000111,0.071965,0.072076
9,14,23,6678,1236153,1242831,0.000281,0.021412,0.021693
10,14,24,15626,620300,635926,0.000653,0.010860,0.011513
9,13,22,6098,216276,222374,0.000251,0.003955,0.004206
10,13,23,23228,14789,38017,0.000957,0.000392,0.001349
8,14,22,4321,169438,173759,0.000169,0.003279,0.003448
10,15,25,45605,5627540,5673145,0.001568,0.113260,0.114828
9,15,24,6864,151700,158564,0.000340,0.002972,0.003312
10,14,24,49831,53697,103528,0.001872,0.001267,0.003139
10,13,23,13345,13507,26852,0.000504,0.000320,0.000824
9,15,24,5591,2415061,2420652,0.000223,0.067194,0.067417
9,14,23,9137,1322872,1332009,0.000480,0.028769,0.029249
10,15,25,20889,332221,353110,0.000942,0.007783,0.008725
10,15,25,14133,2260245,2274378,0.000670,0.047001,0.047671
10,13,23,7977,239703,247680,0.000578,0.005373,0.005951
9,14,23,9824,195949,205773,0.000839,0.004922,0.005761
10,13,23,52408,87247,139655,0.003047,0.002269,0.005316
10,14,24,41909,1657120,1699029,0.001830,0.036751,0.038581
9,13,22,8663,25291,33954,0.000395,0.000545,0.000940
9,14,23,2518,567940,570458,0.000113,0.012329,0.012442
10,13,23,107126,239713,346839,0.003939,0.005868,0.009807
9,15,24,1000,271844,272844,0.000044,0.006395,0.006439
10,14,24,36396,2230143,2266539,0.001490,0.046068,0.047558
10,15,25,23777,601056,624833,0.000908,0.012102,0.013010
10,15,25,13601,1951094,1964695,0.000574,0.034635,0.035209
11,14,25,97419,227878,325297,0.003467,0.004700,0.008167
10,15,25,7132,257094,264226,0.000284,0.005788,0.006072
9,15,24,3090,514313,517403,0.000132,0.011937,0.012069
10,14,24,17680,170036,187716,0.000806,0.003902,0.004708
8,14,22,629,1063829,1064458,0.000029,0.023183,0.023212
10,14,24,9265,3618553,3627818,0.000670,0.075236,0.075906
8,14,22,1125,1263457,1264582,0.000053,0.022554,0.022607
9,15,24,1177,4985533,4986710,0.000066,0.112773,0.112839
10,14,24,9916,1883005,1892921,0.000520,0.042286,0.042806
9,14,23,6120,399224,405344,0.000323,0.009671,0.009994
9,13,22,2792,1069269,1072061,0.000150,0.022329,0.022479
10,13,23,34568,8079,42647,0.001581,0.000408,0.001989
10,14,24,30977,522489,553466,0.001504,0.012724,0.014228
10,14,24,11594,129978,141572,0.000547,0.003035,0.003582
11,14,25,91831,14962,106793,0.003814,0.000682,0.004496
10,13,23,26496,82848,109344,0.001080,0.002395,0.003475
9,15,24,17450,196221,213671,0.000660,0.006520,0.007180
9,15,24,1532,1183471,1185003,0.000083,0.031610,0.031693
9,14,23,6369,145340,151709,0.000331,0.003425,0.003756
9,13,22,1408,66712,68120,0.000079,0.001598,0.001677
9,14,23,4406,73285,77691,0.000224,0.002134,0.002358
10,14,24,15211,139968,155179,0.000693,0.003380,0.004073
9,14,23,12646,2051130,2063776,0.000548,0.042739,0.043287
10,15,25,12986,2762204,2775190,0.000591,0.053878,0.054469
10,15,25,31288,2161816,2193104,0.001263,0.048512,0.049775
7,14,21,189,130851,131040,0.000010,0.003096,0.003106
10,14,24,20015,220386,240401,0.000961,0.005360,0.006321
8,14,22,1038,1823565,1824603,0.000053,0.042944,0.042997
9,14,23,12390,241597,253987,0.000561,0.005546,0.006107
9,15,24,1243,334285,335528,0.000064,0.007974,0.008038
9,13,22,3324,239764,243088,0.000176,0.005146,0.005322
10,12,22,41081,1812,42893,0.001757,0.000074,0.001831
11,13,24,60309,4644,64953,0.002479,0.000140,0.002619
10,13,23,35314,410301,445615,0.001315,0.010118,0.011433
10,15,25,18383,20840710,20859093,0.000804,0.393459,0.394263
9,15,24,1979,631023,633002,0.000101,0.011447,0.011548
10,14,24,36099,403559,439658,0.001437,0.010222,0.011659
8,13,21,1182,3065,4247,0.000066,0.000099,0.000165
10,15,25,12508,4058087,4070595,0.000607,0.081348,0.081955
10,14,24,21878,252297,274175,0.001005,0.005224,0.006229
11,15,26,174421,2235580,2410001,0.005772,0.056085,0.061857
10,15,25,14993,805328,820321,0.000647,0.019980,0.020627
10,13,23,19634,1076209,1095843,0.000853,0.021197,0.022050
10,14,24,10984,889365,900349,0.000499,0.016701,0.017200
10,14,24,22583,190620,213203,0.000972,0.003944,0.004916
10,12,22,6992,25327,32319,0.000313,0.000588,0.000901
10,13,23,37688,8693,46381,0.001492,0.000266,0.001758
9,12,21,5394,53309,58703,0.000210,0.001314,0.001524
10,14,24,10367,353552,363919,0.000665,0.008171,0.008836
8,12,20,1278,87928,89206,0.000080,0.002122,0.002202
10,12,22,23331,25032,48363,0.001050,0.000689,0.001739
10,13,23,19641,155971,175612,0.000837,0.003891,0.004728
9,14,23,6165,326625,332790,0.000295,0.008157,0.008452
10,15,25,13391,1206592,1219983,0.000659,0.027872,0.028531
9,14,23,5270,332206,337476,0.000270,0.008186,0.008456
8,14,22,301,2189055,2189356,0.000016,0.045991,0.046007
10,14,24,55009,445349,500358,0.002372,0.010443,0.012815
10,15,25,8300,1481213,1489513,0.000524,0.036178,0.036702
9,15,24,6005,608085,614090,0.000294,0.013086,0.013380
9,14,23,2422,920467,922889,0.000118,0.021691,0.021809
10,16,26,9367,3775419,3784786,0.000547,0.080882,0.081429
9,14,23,18025,1140050,1158075,0.000799,0.025258,0.026057
10,13,23,27660,278284,305944,0.001471,0.005925,0.007396
10,14,24,9931,102557,112488,0.000486,0.002424,0.002910
10,13,23,21219,205555,226774,0.000955,0.005025,0.005980
10,15,25,26485,1672910,1699395,0.002041,0.041153,0.043194
9,14,23,5530,734174,739704,0.000340,0.020717,0.021057
10,14,24,19604,173301,192905,0.001177,0.006834,0.008011
9,14,23,639,606002,606641,0.000047,0.022486,0.022533
10,15,25,4787,1522518,1527305,0.000329,0.051571,0.051900
10,16,26,64599,2154118,2218717,0.003145,0.062801,0.065946
10,16,26,15315,2648085,2663400,0.000918,0.064722,0.065640
10,15,25,20985,652333,673318,0.000842,0.018689,0.019531
9,15,24,15975,4555499,4571474,0.001000,0.097654,0.098654
10,14,24,17421,370299,387720,0.000779,0.008965,0.009744
9,16,25,2511,3394011,3396522,0.000118,0.083309,0.083427
9,14,23,3571,487392,490963,0.000209,0.012189,0.012398
10,14,24,27388,2513885,2541273,0.001398,0.058037,0.059435
10,14,24,17703,203305,221008,0.000863,0.005150,0.006013
9,14,23,11327,368045,379372,0.000516,0.008795,0.009311
9,15,24,1975,849093,851068,0.000103,0.020957,0.021060
11,14,25,164450,206455,370905,0.007075,0.005683,0.012758
10,15,25,11789,1767148,1778937,0.000593,0.044828,0.045421
10,15,25,86977,1247563,1334540,0.004193,0.038573,0.042766
9,14,23,8872,254310,263182,0.000555,0.007617,0.008172
9,13,22,2955,228178,231133,0.000154,0.006875,0.007029
10,15,25,12135,197674,209809,0.000634,0.006118,0.006752
9,14,23,4435,1013410,1017845,0.000264,0.028853,0.029117
9,15,24,2104,3184493,3186597,0.000116,0.076315,0.076431
10,15,25,12307,1786403,1798710,0.000600,0.041717,0.042317
10,14,24,22533,760104,782637,0.001134,0.019980,0.021114
9,14,23,5381,1117277,1122658,0.000278,0.028005,0.028283
10,15,25,31416,1121186,1152602,0.001427,0.027551,0.028978
10,16,26,31419,7039244,7070663,0.001488,0.153541,0.155029
10,14,24,30730,59088,89818,0.001318,0.001595,0.002913
9,13,22,2846,38424,41270,0.000123,0.000781,0.000904
10,16,26,41827,1525736,1567563,0.001589,0.033266,0.034855
9,15,24,1864,1152392,1154256,0.000103,0.025732,0.025835
9,14,23,5539,1247061,1252600,0.000273,0.023848,0.024121
10,13,23,16102,19685,35787,0.000691,0.000493,0.001184
10,15,25,10847,1088673,1099520,0.000531,0.024599,0.025130
9,15,24,4377,2192959,2197336,0.000226,0.048704,0.048930
11,14,25,143090,130765,273855,0.005623,0.003694,0.009317
10,13,23,31623,242315,273938,0.001354,0.006517,0.007871
10,12,22,10456,47608,58064,0.000565,0.001346,0.001911
10,14,24,32486,1030648,1063134,0.001575,0.030505,0.032080
10,15,25,23202,18798044,18821246,0.001220,0.486066,0.487286
8,13,21,700,142908,143608,0.000045,0.003656,0.003701
8,13,21,2359,59783,62142,0.000122,0.001455,0.001577
9,14,23,10075,490357,500432,0.000558,0.012361,0.012919
10,14,24,14734,1541019,1555753,0.000718,0.036140,0.036858
9,14,23,12762,133013,145775,0.000641,0.003248,0.003889
8,14,22,444,433562,434006,0.000023,0.010748,0.010771
8,13,21,304,217508,217812,0.000017,0.005410,0.005427
9,14,23,1089,323674,324763,0.000061,0.007493,0.007554
9,14,23,5477,1761608,1767085,0.000278,0.041617,0.041895
9,14,23,5375,306403,311778,0.000280,0.007603,0.007883
9,15,24,2711,462048,464759,0.000143,0.010393,0.010536
10,14,24,24203,710909,735112,0.001133,0.017602,0.018735
9,13,22,5069,14016,19085,0.000287,0.000557,0.000844
8,15,23,851,217118,217969,0.000046,0.005888,0.005934
9,14,23,6750,2434230,2440980,0.000358,0.064905,0.065263
10,15,25,31027,3834673,3865700,0.001613,0.096080,0.097693
10,14,24,17861,697329,715190,0.000914,0.017144,0.018058
10,14,24,23305,173419,196724,0.001197,0.004343,0.005540
9,14,23,7760,477167,484927,0.000395,0.011732,0.012127
10,14,24,20297,278253,298550,0.000981,0.006809,0.007790
9,13,22,949,155679,156628,0.000054,0.004264,0.004318
9,15,24,1988,3942982,3944970,0.000105,0.097433,0.097538
11,12,23,134066,113714,247780,0.006195,0.003084,0.009279
10,14,24,41006,243514,284520,0.001900,0.006784,0.008684
9,16,25,6055,1714304,1720359,0.000343,0.056078,0.056421
9,15,24,2242,205965,208207,0.000145,0.006633,0.006778
10,14,24,40912,135379,176291,0.001997,0.004234,0.006231
10,15,25,13476,1765702,1779178,0.000801,0.055719,0.056520
10,15,25,13709,737540,751249,0.000828,0.024305,0.025133
10,13,23,24927,360730,385657,0.001465,0.011887,0.013352
10,16,26,9066,4339939,4349005,0.000663,0.125001,0.125664
9,15,24,2930,1871897,1874827,0.000153,0.045130,0.045283
9,14,23,6173,671486,677659,0.000313,0.016172,0.016485
9,14,23,3472,3060439,3063911,0.000177,0.074001,0.074178
10,13,23,64381,42541,106922,0.003016,0.001423,0.004439
10,16,26,25306,4478068,4503374,0.001178,0.115766,0.116944
9,13,22,2976,95788,98764,0.000165,0.002182,0.002347
9,15,24,9871,2491144,2501015,0.000459,0.056070,0.056529
10,15,25,40516,1261011,1301527,0.001819,0.031722,0.033541
9,14,23,5870,135652,141522,0.000365,0.003719,0.004084
9,15,24,5989,3250208,3256197,0.000351,0.099553,0.099904
10,16,26,23818,3892387,3916205,0.001308,0.109400,0.110708
9,14,23,14287,51619,65906,0.000831,0.001884,0.002715
9,14,23,3802,468000,471802,0.000233,0.014174,0.014407
9,14,23,5500,271092,276592,0.000396,0.008464,0.008860
10,11,21,19371,7119,26490,0.001084,0.000265,0.001349
10,15,25,90343,1918545,2008888,0.004069,0.058169,0.062238
9,13,22,4900,135409,140309,0.000302,0.004152,0.004454
9,15,24,5126,709628,714754,0.000279,0.019611,0.019890
10,14,24,16037,2222499,2238536,0.000828,0.065012,0.065840
9,14,23,5678,156870,162548,0.000325,0.004734,0.005059
10,14,24,36223,147223,183446,0.002017,0.005540,0.007557
10,14,24,30369,155166,185535,0.001486,0.004933,0.006419
9,14,23,10518,236926,247444,0.000521,0.007729,0.008250
8,15,23,169,1078809,1078978,0.000008,0.033228,0.033236
10,16,26,14396,16776946,16791342,0.000808,0.457467,0.458275
10,15,25,32774,935264,968038,0.001793,0.025790,0.027583
9,16,25,7044,9211196,9218240,0.000322,0.250525,0.250847
9,14,23,2408,235339,237747,0.000132,0.005450,0.005582
9,14,23,6369,20251,26620,0.000317,0.000739,0.001056
10,15,25,23930,358750,382680,0.000996,0.008939,0.009935
9,13,22,1557,303654,305211,0.000076,0.006986,0.007062
9,13,22,2870,118400,121270,0.000147,0.002810,0.002957
10,14,24,7136,258553,265689,0.000371,0.005914,0.006285
10,14,24,46379,134767,181146,0.001963,0.003463,0.005426
9,14,23,3717,99052,102769,0.000191,0.002662,0.002853
9,14,23,4116,177528,181644,0.000205,0.004850,0.005055
9,14,23,4530,1873650,1878180,0.000249,0.045035,0.045284
10,15,25,6469,1025804,1032273,0.000344,0.025108,0.025452
10,14,24,45409,94509,139918,0.002150,0.002623,0.004773
10,14,24,26818,178336,205154,0.001162,0.005029,0.006191
10,13,23,13055,120398,133453,0.000691,0.003784,0.004475
8,14,22,2591,42792,45383,0.000137,0.001617,0.001754
9,14,23,1411,248254,249665,0.000082,0.007076,0.007158
10,14,24,26489,229240,255729,0.001334,0.006757,0.008091
10,16,26,61491,15857115,15918606,0.002904,0.364429,0.367333
10,15,25,48377,926655,975032,0.002326,0.030320,0.032646
9,15,24,643,159654,160297,0.000042,0.005155,0.005197
9,15,24,2433,965329,967762,0.000149,0.026929,0.027078
10,15,25,14688,1951675,1966363,0.000815,0.047408,0.048223
10,14,24,16274,25566,41840,0.000729,0.000879,0.001608
10,14,24,23499,97895,121394,0.001064,0.002682,0.003746
10,16,26,27206,1632878,1660084,0.001207,0.039360,0.040567
10,15,25,7214,4397835,4405049,0.000371,0.103587,0.103958
9,12,21,8566,42005,50571,0.000449,0.001057,0.001506
9,16,25,6440,4113097,4119537,0.000310,0.098995,0.099305
10,13,23,14599,6621,21220,0.000697,0.000204,0.000901
10,13,23,45238,14568,59806,0.001926,0.000640,0.002566
8,15,23,603,498610,499213,0.000026,0.012885,0.012911
10,14,24,11562,89364,100926,0.000571,0.002494,0.003065
10,15,25,17841,2859755,2877596,0.000834,0.066354,0.067188
11,14,25,140656,147857,288513,0.004902,0.003622,0.008524
10,16,26,11724,6043507,6055231,0.000495,0.130765,0.131260
9,15,24,6721,578300,585021,0.000292,0.013722,0.014014
10,16,26,13653,6646693,6660346,0.000668,0.196721,0.197389
9,15,24,2815,193265,196080,0.000160,0.005210,0.005370
9,14,23,2122,417156,419278,0.000118,0.010736,0.010854
8,14,22,1017,567371,568388,0.000055,0.013782,0.013837
9,13,22,6951,215167,222118,0.000295,0.005163,0.005458
9,14,23,6236,888731,894967,0.000315,0.020955,0.021270
10,13,23,17284,40099,57383,0.000873,0.000962,0.001835
9,14,23,1143,439541,440684,0.000059,0.010790,0.010849
10,15,25,8013,350568,358581,0.000415,0.009104,0.009519
10,12,22,21405,982,22387,0.001093,0.000047,0.001140
9,14,23,3964,1064340,1068304,0.000205,0.025596,0.025801
10,14,24,17594,485298,502892,0.000839,0.011144,0.011983
10,14,24,18362,2633936,2652298,0.000764,0.059766,0.060530
9,15,24,2947,425920,428867,0.000132,0.009869,0.010001
9,14,23,572,50074,50646,0.000030,0.001227,0.001257
9,15,24,3423,1166708,1170131,0.000170,0.029586,0.029756
10,14,24,38968,2794109,2833077,0.001858,0.069277,0.071135
10,15,25,10193,4069456,4079649,0.000516,0.099917,0.100433
9,14,23,10206,308917,319123,0.000531,0.007925,0.008456
9,14,23,3675,270932,274607,0.000205,0.006604,0.006809
10,12,22,56467,120003,176470,0.002788,0.003848,0.006636
9,15,24,5966,2141540,2147506,0.000359,0.059504,0.059863
10,15,25,67540,221744,289284,0.003447,0.006757,0.010204
9,13,22,11898,319545,331443,0.000563,0.008309,0.008872
10,15,25,13069,3511024,3524093,0.000692,0.087554,0.088246
10,14,24,12991,321050,334041,0.000647,0.008161,0.008808
8,13,21,2215,358350,360565,0.000123,0.009147,0.009270
9,14,23,1660,2408109,2409769,0.000098,0.062002,0.062100
9,16,25,3204,4579491,4582695,0.000207,0.126279,0.126486
10,15,25,14063,864125,878188,0.000731,0.023446,0.024177
10,13,23,20374,449745,470119,0.001032,0.011099,0.012131
10,15,25,15708,732399,748107,0.000863,0.018041,0.018904
8,12,20,379,19837,20216,0.000020,0.000555,0.000575
10,13,23,42395,278387,320782,0.001862,0.007255,0.009117
9,15,24,25769,284885,310654,0.001057,0.007862,0.008919
10,13,23,65886,85832,151718,0.003154,0.002606,0.005760
9,15,24,1350,275724,277074,0.000078,0.008070,0.008148
10,13,23,35161,421053,456214,0.001620,0.011769,0.013389
10,13,23,30981,264097,295078,0.001549,0.007724,0.009273
9,13,22,5612,1575015,1580627,0.000271,0.037700,0.037971
9,13,22,757,173835,174592,0.000043,0.004271,0.004314
9,14,23,567,1069956,1070523,0.000033,0.024511,0.024544
10,14,24,19938,139989,159927,0.000888,0.003638,0.004526
10,13,23,36686,26103,62789,0.001624,0.000778,0.002402
9,12,21,17248,589,17837,0.000693,0.000029,0.000722
8,14,22,424,1493972,1494396,0.000022,0.037060,0.037082
10,14,24,31772,852918,884690,0.001570,0.019687,0.021257
10,14,24,26392,126741,153133,0.001230,0.003382,0.004612
9,13,22,6133,291843,297976,0.000321,0.007536,0.007857
9,13,22,6933,16460,23393,0.000332,0.000538,0.000870
11,16,27,80529,24229944,24310473,0.003476,0.521732,0.525208
10,14,24,33473,191388,224861,0.001518,0.004957,0.006475
10,15,25,31655,3083266,3114921,0.001299,0.073527,0.074826
9,14,23,6543,1482979,1489522,0.000314,0.038400,0.038714
10,14,24,9583,219012,228595,0.000495,0.005715,0.006210
9,14,23,6477,540282,546759,0.000315,0.013265,0.013580
10,13,23,27610,82724,110334,0.001321,0.002183,0.003504
9,14,23,5867,1119293,1125160,0.000293,0.025502,0.025795
10,14,24,94138,72922,167060,0.004071,0.002103,0.006174
9,15,24,1317,1055044,1056361,0.000059,0.024502,0.024561
11,13,24,48806,203401,252207,0.002225,0.005035,0.007260
10,15,25,32020,1649910,1681930,0.001398,0.037931,0.039329
10,15,25,25143,212664,237807,0.001051,0.004782,0.005833
9,13,22,6685,93989,100674,0.000283,0.002070,0.002353
9,13,22,5931,202747,208678,0.000265,0.004116,0.004381
10,13,23,23883,8786,32669,0.000956,0.000255,0.001211
9,13,22,4310,536390,540700,0.000188,0.014422,0.014610
10,14,24,15152,106366,121518,0.000728,0.002896,0.003624
9,13,22,12544,158589,171133,0.000614,0.003950,0.004564
10,13,23,26463,452526,478989,0.001249,0.011078,0.012327
9,12,21,2441,18788,21229,0.000133,0.000505,0.000638
9,15,24,10263,655540,665803,0.000483,0.015919,0.016402
10,14,24,44859,610917,655776,0.001858,0.014593,0.016451
9,14,23,3408,365789,369197,0.000208,0.009023,0.009231
10,14,24,17623,36426,54049,0.000925,0.000973,0.001898
9,14,23,1642,753410,755052,0.000080,0.017783,0.017863
9,14,23,2203,1709773,1711976,0.000125,0.044071,0.044196
9,13,22,2829,660974,663803,0.000169,0.019364,0.019533
10,14,24,17091,108345,125436,0.000954,0.003378,0.004332
9,15,24,4601,2503465,2508066,0.000246,0.064979,0.065225
9,14,23,4927,604700,609627,0.000276,0.016156,0.016432
10,13,23,76402,208414,284816,0.003523,0.006454,0.009977
10,12,22,33193,4147,37340,0.001774,0.000189,0.001963
9,15,24,30619,2252230,2282849,0.001416,0.066089,0.067505
9,14,23,7811,41530,49341,0.000435,0.001224,0.001659
9,15,24,2948,767893,770841,0.000156,0.019250,0.019406
10,14,24,30170,485378,515548,0.001386,0.012429,0.013815
10,14,24,19179,322544,341723,0.000918,0.007892,0.008810
10,14,24,11013,116937,127950,0.000550,0.002988,0.003538
9,13,22,1868,120201,122069,0.000098,0.003057,0.003155
9,14,23,2085,375081,377166,0.000111,0.009487,0.009598
10,14,24,10960,1844223,1855183,0.000610,0.044270,0.044880
9,14,23,3917,1516338,1520255,0.000240,0.038379,0.038619
9,14,23,9853,27337981,27347834,0.000588,0.570983,0.571571
9,12,21,9634,402,10036,0.000520,0.000019,0.000539
10,13,23,14375,1096,15471,0.000652,0.000048,0.000700
9,14,23,12071,442775,454846,0.000536,0.010122,0.010658
10,15,25,18844,760388,779232,0.000838,0.017532,0.018370
9,14,23,9263,121618,130881,0.000460,0.002889,0.003349
10,13,23,12611,152119,164730,0.000672,0.003587,0.004259
9,14,23,4383,134290,138673,0.000211,0.003387,0.003598
9,13,22,4860,380857,385717,0.000237,0.008693,0.008930
9,13,22,916,312985,313901,0.000051,0.007332,0.007383
9,15,24,1247,1008266,1009513,0.000071,0.032298,0.032369
10,16,26,26709,3455694,3482403,0.001266,0.090946,0.092212
10,14,24,6871,305796,312667,0.000390,0.007792,0.008182
9,14,23,4057,220164,224221,0.000234,0.005614,0.005848
10,14,24,48643,257375,306018,0.002212,0.006731,0.008943
8,15,23,546,769594,770140,0.000028,0.020520,0.020548
7,15,22,155,1307066,1307221,0.000007,0.033632,0.033639
8,15,23,847,7149921,7150768,0.000080,0.158901,0.158981
11,14,25,78574,225954,304528,0.003017,0.006043,0.009060
10,14,24,20373,1851287,1871660,0.000946,0.039993,0.040939
9,14,23,3925,3853337,3857262,0.000197,0.067966,0.068163
10,14,24,15825,1354148,1369973,0.000706,0.025128,0.025834
9,15,24,2521,565838,568359,0.000139,0.015561,0.015700
10,14,24,13660,4588644,4602304,0.000722,0.101682,0.102404
9,14,23,9107,62554,71661,0.000609,0.002658,0.003267
9,14,23,35889,254429,290318,0.001501,0.006094,0.007595
10,13,23,13022,25878,38900,0.000606,0.000782,0.001388
10,14,24,12651,794251,806902,0.000547,0.020987,0.021534
9,15,24,2806,1776096,1778902,0.000163,0.037891,0.038054
9,13,22,9065,95123,104188,0.000395,0.001860,0.002255
9,12,21,5870,102730,108600,0.000303,0.002099,0.002402
9,15,24,7430,3095108,3102538,0.000436,0.073621,0.074057
10,15,25,20293,288271,308564,0.000882,0.006459,0.007341
9,15,24,2607,895586,898193,0.000122,0.016699,0.016821
10,14,24,18709,315819,334528,0.000804,0.007668,0.008472
9,13,22,4264,58263,62527,0.000206,0.001133,0.001339
9,14,23,8208,321913,330121,0.000335,0.006590,0.006925
10,13,23,37321,35838,73159,0.001306,0.000789,0.002095
9,14,23,11468,363138,374606,0.000438,0.007775,0.008213
10,14,24,20420,189599,210019,0.000896,0.004459,0.005355
10,16,26,24363,1599265,1623628,0.001024,0.036392,0.037416
9,15,24,3801,1367536,1371337,0.000173,0.025717,0.025890
10,14,24,58587,646019,704606,0.001913,0.013022,0.014935
10,12,22,13745,14962,28707,0.000583,0.000330,0.000913
10,14,24,62103,1439480,1501583,0.002082,0.030833,0.032915
10,12,22,36898,2026,38924,0.001645,0.000061,0.001706
8,14,22,9834,1287040,1296874,0.000317,0.028356,0.028673
10,14,24,82828,186734,269562,0.003210,0.004536,0.007746
10,15,25,13975,1162186,1176161,0.000585,0.026334,0.026919
9,14,23,13706,398377,412083,0.000595,0.008979,0.009574
9,14,23,4534,1527092,1531626,0.000215,0.029440,0.029655
9,15,24,9813,2497598,2507411,0.000398,0.043555,0.043953
10,12,22,22010,21436,43446,0.000942,0.000442,0.001384
10,15,25,22015,3025339,3047354,0.000823,0.069749,0.070572
10,13,23,24344,47898,72242,0.001062,0.000957,0.002019
10,16,26,48000,1474647,1522647,0.001971,0.035305,0.037276
10,15,25,16002,719849,735851,0.000801,0.019640,0.020441
8,14,22,542,118155,118697,0.000044,0.003371,0.003415
9,14,23,5910,519292,525202,0.000291,0.013036,0.013327
9,15,24,1600,1778192,1779792,0.000095,0.041861,0.041956
9,14,23,7870,159042,166912,0.000433,0.004145,0.004578
10,14,24,29274,351819,381093,0.001358,0.008382,0.009740
10,14,24,22613,156607,179220,0.001040,0.003948,0.004988
11,15,26,150839,2046252,2197091,0.005819,0.049937,0.055756
10,15,25,9353,921002,930355,0.000490,0.020439,0.020929
9,12,21,2662,24256,26918,0.000138,0.000682,0.000820
9,14,23,4095,142147,146242,0.000219,0.003551,0.003770
10,15,25,8251,918861,927112,0.000405,0.021241,0.021646
8,15,23,3364,1374213,1377577,0.000162,0.031466,0.031628
10,15,25,55790,300454,356244,0.002461,0.008154,0.010615
10,15,25,29275,481561,510836,0.001378,0.011099,0.012477
9,15,24,2831,460863,463694,0.000143,0.010610,0.010753
10,14,24,25525,173905,199430,0.001163,0.004261,0.005424
9,14,23,3369,999383,1002752,0.000173,0.022940,0.023113
9,13,22,3333,12835,16168,0.000185,0.000388,0.000573
9,9,18,8952,141,9093,0.000429,0.000005,0.000434
10,13,23,13302,723039,736341,0.000606,0.016388,0.016994
9,12,21,3295,136304,139599,0.000170,0.002949,0.003119
10,13,23,7588,28318,35906,0.000377,0.000698,0.001075
10,13,23,21276,137465,158741,0.000939,0.003553,0.004492
9,15,24,10036,817611,827647,0.000425,0.019839,0.020264
10,13,23,42978,500681,543659,0.001939,0.012241,0.014180
9,14,23,2001,781398,783399,0.000106,0.017710,0.017816
9,13,22,1090,18481,19571,0.000060,0.000501,0.000561
10,13,23,18842,9220,28062,0.000880,0.000268,0.001148
9,14,23,5144,619299,624443,0.000236,0.014444,0.014680
9,15,24,1739,3502095,3503834,0.000088,0.066183,0.066271
10,14,24,38295,642406,680701,0.001553,0.013895,0.015448
10,13,23,19310,117056,136366,0.001079,0.003852,0.004931
9,15,24,5541,390463,396004,0.000419,0.015462,0.015881
9,15,24,7034,297693,304727,0.000414,0.011246,0.011660
10,15,25,75686,956042,1031728,0.003797,0.027019,0.030816
8,11,19,254,1198,1452,0.000012,0.000044,0.000056
9,16,25,8509,2217051,2225560,0.000473,0.055860,0.056333
9,13,22,2521,39459,41980,0.000139,0.001349,0.001488
11,14,25,221646,19593,241239,0.008186,0.000670,0.008856
8,14,22,2667,970029,972696,0.000118,0.023416,0.023534
9,16,25,1035,2171434,2172469,0.000049,0.046996,0.047045
10,14,24,10296,3431442,3441738,0.000418,0.060694,0.061112
10,15,25,6136,600576,606712,0.000265,0.011713,0.011978
10,14,24,25664,1055147,1080811,0.001084,0.019842,0.020926
9,14,23,1850,1186456,1188306,0.000078,0.021105,0.021183
9,14,23,4745,391925,396670,0.000200,0.007075,0.007275
10,15,25,13185,3098185,3111370,0.000514,0.071344,0.071858
9,13,22,5834,7219,13053,0.000344,0.000287,0.000631
10,13,23,40419,223960,264379,0.001824,0.006306,0.008130
10,14,24,19884,2474432,2494316,0.001018,0.073265,0.074283
9,14,23,6319,409373,415692,0.000407,0.012721,0.013128
10,11,21,71994,8637,80631,0.003686,0.000319,0.004005
10,14,24,55924,606204,662128,0.002788,0.019217,0.022005
10,13,23,69720,13192,82912,0.003178,0.000485,0.003663
10,12,22,7304,18402,25706,0.000374,0.000744,0.001118
10,11,21,46217,2286,48503,0.002202,0.000142,0.002344
10,15,25,50765,1474226,1524991,0.002573,0.046318,0.048891
10,14,24,18997,1253057,1272054,0.001058,0.037403,0.038461
11,14,25,65793,1354900,1420693,0.003485,0.040112,0.043597
10,14,24,130605,178519,309124,0.005597,0.005506,0.011103
10,14,24,47941,227777,275718,0.002058,0.006559,0.008617
10,15,25,118543,911999,1030542,0.005136,0.025288,0.030424
10,13,23,28692,112307,140999,0.001425,0.003527,0.004952
9,15,24,689,1072866,1073555,0.000039,0.029014,0.029053
10,14,24,36387,334415,370802,0.001587,0.008837,0.010424
10,13,23,18087,60591,78678,0.000854,0.001386,0.002240
9,13,22,8433,182102,190535,0.000385,0.004435,0.004820
10,14,24,13925,1525542,1539467,0.000610,0.034332,0.034942
10,15,25,55286,952516,1007802,0.002450,0.022892,0.025342
9,14,23,3644,36933,40577,0.000200,0.001128,0.001328
8,15,23,705,2713549,2714254,0.000036,0.063910,0.063946
10,14,24,5138,859882,865020,0.000276,0.020115,0.020391
10,15,25,62884,2329760,2392644,0.002524,0.054546,0.057070
10,14,24,35833,58793,94626,0.001716,0.001554,0.003270
8,14,22,950,1313957,1314907,0.000047,0.029877,0.029924
9,14,23,8671,1075141,1083812,0.000406,0.023441,0.023847
10,11,21,42634,5583,48217,0.002026,0.000203,0.002229
10,13,23,30026,43584,73610,0.001267,0.001267,0.002534
10,13,23,28863,944932,973795,0.001237,0.021588,0.022825
9,15,24,5053,494196,499249,0.000243,0.012080,0.012323
10,15,25,13806,1264160,1277966,0.000685,0.029335,0.030020
9,12,21,1891,16357,18248,0.000105,0.000412,0.000517
9,15,24,2320,353521,355841,0.000128,0.008500,0.008628
10,13,23,23796,154550,178346,0.001087,0.003624,0.004711
10,13,23,64138,68311,132449,0.002623,0.001719,0.004342
9,14,23,10698,360867,371565,0.000439,0.008516,0.008955
8,15,23,1588,1674167,1675755,0.000073,0.038960,0.039033
10,13,23,84398,965598,1049996,0.003397,0.021927,0.025324
10,15,25,5753,211020,216773,0.000301,0.006062,0.006363
8,14,22,580,5453222,5453802,0.000034,0.108739,0.108773
9,15,24,5531,3952709,3958240,0.000265,0.086752,0.087017
10,13,23,34427,8848,43275,0.001496,0.000334,0.001830
9,14,23,2025,503681,505706,0.000096,0.012070,0.012166
9,14,23,8636,248144,256780,0.000463,0.005684,0.006147
9,15,24,18789,327860,346649,0.000855,0.008728,0.009583
10,14,24,26151,1280674,1306825,0.001229,0.029826,0.031055
10,14,24,13149,3245961,3259110,0.000709,0.070790,0.071499
9,15,24,1541,1744478,1746019,0.000077,0.042960,0.043037
9,11,20,1847,2576,4423,0.000153,0.000284,0.000437
10,14,24,24460,94792,119252,0.002639,0.002606,0.005245
9,14,23,6033,151495,157528,0.000248,0.003575,0.003823
9,15,24,4134,1207225,1211359,0.000188,0.027114,0.027302
9,16,25,7352,3504570,3511922,0.000372,0.072538,0.072910
9,15,24,5375,259349,264724,0.000266,0.005354,0.005620
9,14,23,9282,96022,105304,0.000431,0.002177,0.002608
9,15,24,5100,1534062,1539162,0.000248,0.032054,0.032302
10,13,23,34159,3089,37248,0.001205,0.000094,0.001299
10,14,24,12420,77531,89951,0.000528,0.001642,0.002170
10,12,22,92303,32890,125193,0.003018,0.000722,0.003740
10,13,23,27292,387569,414861,0.001002,0.009204,0.010206
10,14,24,61522,816716,878238,0.002507,0.019031,0.021538
9,13,22,3095,295907,299002,0.000140,0.006139,0.006279
9,13,22,5339,47603,52942,0.000227,0.001130,0.001357
10,14,24,15603,613460,629063,0.000698,0.014588,0.015286
8,13,21,440,168564,169004,0.000025,0.004202,0.004227
8,13,21,653,223109,223762,0.000037,0.005391,0.005428
10,16,26,25293,2984857,3010150,0.001088,0.067305,0.068393
8,15,23,1616,941753,943369,0.000083,0.020669,0.020752
10,15,25,29140,553530,582670,0.001218,0.014985,0.016203
10,15,25,18103,3194678,3212781,0.000833,0.078061,0.078894
8,15,23,829,532936,533765,0.000050,0.012732,0.012782
9,14,23,1868,3237549,3239417,0.000097,0.067676,0.067773
10,14,24,26541,491066,517607,0.001099,0.010128,0.011227
10,12,22,71107,25876,96983,0.002618,0.000797,0.003415
10,15,25,63945,798391,862336,0.002884,0.021769,0.024653
9,14,23,7603,1492545,1500148,0.000357,0.031865,0.032222
9,13,22,5725,199152,204877,0.000280,0.004274,0.004554
10,13,23,9998,69577,79575,0.000476,0.001623,0.002099
9,14,23,3014,2313491,2316505,0.000144,0.049692,0.049836
10,14,24,10915,652315,663230,0.000490,0.012001,0.012491
9,14,23,1322,1215995,1217317,0.000063,0.023764,0.023827
10,14,24,29262,453651,482913,0.001160,0.009518,0.010678
10,14,24,77192,310911,388103,0.003149,0.007407,0.010556
9,14,23,6855,113383,120238,0.000289,0.002750,0.003039
8,16,24,2618,3256288,3258906,0.000117,0.066895,0.067012
10,13,23,24147,171812,195959,0.001011,0.003340,0.004351
9,13,22,1987,140177,142164,0.000089,0.002611,0.002700
7,15,22,242,275279,275521,0.000008,0.005807,0.005815
9,15,24,2412,1025701,1028113,0.000118,0.023203,0.023321
9,14,23,2675,802822,805497,0.000131,0.014406,0.014537
9,13,22,3664,67767,71431,0.000170,0.001347,0.001517
10,13,23,19864,299121,318985,0.000804,0.004831,0.005635
10,14,24,55398,595122,650520,0.002079,0.012757,0.014836
10,14,24,39720,822523,862243,0.001648,0.018981,0.020629
10,15,25,5762,225526,231288,0.000262,0.005232,0.005494
9,15,24,1212,4350830,4352042,0.000062,0.103695,0.103757
10,14,24,95041,833137,928178,0.004444,0.021575,0.026019
9,14,23,4765,336889,341654,0.000259,0.008297,0.008556
10,15,25,26684,6285319,6312003,0.001323,0.147281,0.148604
9,14,23,7029,487213,494242,0.000391,0.011923,0.012314
9,12,21,12556,72657,85213,0.000574,0.001681,0.002255
10,15,25,41001,975877,1016878,0.001744,0.023165,0.024909
10,13,23,54043,55089,109132,0.002375,0.001500,0.003875
9,14,23,21769,44600,66369,0.000780,0.001337,0.002117
10,14,24,15871,1905948,1921819,0.000659,0.042644,0.043303
10,12,22,35720,10393,46113,0.001672,0.000339,0.002011
9,14,23,2017,428057,430074,0.000101,0.009902,0.010003
10,13,23,8448,101789,110237,0.000418,0.002342,0.002760
10,16,26,22009,11834601,11856610,0.001008,0.265963,0.266971
9,13,22,3609,562449,566058,0.000224,0.012200,0.012424
9,13,22,2996,75109,78105,0.000157,0.001984,0.002141
8,15,23,1340,5724000,5725340,0.000064,0.118442,0.118506
10,14,24,34240,540275,574515,0.001540,0.010227,0.011767
10,14,24,30397,819387,849784,0.001275,0.015676,0.016951
10,14,24,29001,186874,215875,0.001173,0.003754,0.004927
10,14,24,16463,124041,140504,0.000662,0.002797,0.003459
10,12,22,39388,23420,62808,0.001625,0.000606,0.002231
9,14,23,10447,1975741,1986188,0.000391,0.038150,0.038541
10,15,25,28440,919070,947510,0.001283,0.018902,0.020185
10,12,22,37214,39941,77155,0.001585,0.000930,0.002515
10,14,24,19673,303198,322871,0.000800,0.006492,0.007292
9,15,24,4143,1257970,1262113,0.000186,0.024191,0.024377
9,13,22,13795,15354,29149,0.000577,0.000355,0.000932
9,12,21,1899,4072,5971,0.000088,0.000134,0.000222
10,14,24,18051,1265172,1283223,0.000776,0.025017,0.025793
10,13,23,9787,432510,442297,0.000447,0.008495,0.008942
9,14,23,1374,1302680,1304054,0.000068,0.025142,0.025210
10,16,26,15975,9566331,9582306,0.000718,0.233587,0.234305
10,15,25,18401,589890,608291,0.000820,0.011767,0.012587
10,12,22,27695,46343,74038,0.001168,0.001061,0.002229
9,15,24,7263,2529988,2537251,0.000335,0.048225,0.048560
8,14,22,760,59532,60292,0.000039,0.001363,0.001402
10,15,25,23357,690759,714116,0.001015,0.013946,0.014961
10,12,22,16930,16827,33757,0.000739,0.000388,0.001127
9,14,23,5340,874984,880324,0.000246,0.016664,0.016910
11,14,25,149782,1490061,1639843,0.005050,0.032345,0.037395
10,14,24,8556,726778,735334,0.000385,0.013540,0.013925
10,13,23,22794,280997,303791,0.000931,0.005160,0.006091
10,14,24,20908,26579,47487,0.000830,0.000752,0.001582
10,14,24,24909,887357,912266,0.001125,0.015567,0.016692
10,14,24,38000,2009534,2047534,0.001797,0.035012,0.036809
10,15,25,90317,4373235,4463552,0.003877,0.088564,0.092441
10,15,25,57607,2102636,2160243,0.002181,0.039903,0.042084
9,16,25,13082,3259226,3272308,0.000552,0.062686,0.063238
10,14,24,26376,1617584,1643960,0.001208,0.036279,0.037487
11,14,25,112053,348214,460267,0.004718,0.010412,0.015130
10,13,23,21725,90141,111866,0.001113,0.002512,0.003625
10,13,23,4643,13505,18148,0.000257,0.000546,0.000803
9,15,24,9329,3096333,3105662,0.000460,0.071766,0.072226
10,13,23,33738,88525,122263,0.001583,0.002258,0.003841
10,14,24,27112,266090,293202,0.001158,0.006516,0.007674
8,15,23,1211,876261,877472,0.000065,0.020325,0.020390
8,14,22,1025,2183100,2184125,0.000053,0.048126,0.048179
10,15,25,10526,1324888,1335414,0.000545,0.030382,0.030927
9,13,22,3770,256182,259952,0.000211,0.005790,0.006001
10,15,25,21914,1371213,1393127,0.001027,0.033117,0.034144
10,13,23,10146,473967,484113,0.000519,0.010775,0.011294
10,14,24,66420,1235182,1301602,0.002888,0.028904,0.031792
9,12,21,2146,44868,47014,0.000118,0.001088,0.001206
10,15,25,26935,1433751,1460686,0.001213,0.032578,0.033791
10,15,25,43075,1685153,1728228,0.001953,0.039093,0.041046
10,15,25,20840,946624,967464,0.000963,0.023249,0.024212
10,13,23,13447,101126,114573,0.000702,0.002678,0.003380
10,15,25,34590,340585,375175,0.001687,0.009240,0.010927
8,15,23,2385,1193106,1195491,0.000121,0.027534,0.027655
9,15,24,3018,5603523,5606541,0.000165,0.141979,0.142144
11,13,24,64084,84156,148240,0.003120,0.002794,0.005914
9,14,23,4305,535831,540136,0.000225,0.014596,0.014821
10,15,25,19080,1629861,1648941,0.000915,0.041119,0.042034
9,15,24,4930,2179746,2184676,0.000257,0.046037,0.046294
9,12,21,8069,22922,30991,0.000378,0.000522,0.000900
11,14,25,68540,111631,180171,0.002496,0.002491,0.004987
9,12,21,1144,32038,33182,0.000051,0.000808,0.000859
8,13,21,379,421243,421622,0.000016,0.009325,0.009341
9,15,24,2069,2203533,2205602,0.000099,0.048563,0.048662
9,12,21,3489,76002,79491,0.000173,0.001856,0.002029
10,14,24,13058,1316653,1329711,0.000646,0.030117,0.030763
9,13,22,1050,297874,298924,0.000063,0.007212,0.007275
10,13,23,14383,109573,123956,0.000713,0.002880,0.003593
9,15,24,9652,1084690,1094342,0.000408,0.025782,0.026190
10,15,25,18550,3562919,3581469,0.000966,0.085512,0.086478
10,14,24,33045,77235,110280,0.001610,0.002120,0.003730
10,15,25,18319,1472298,1490617,0.000813,0.034990,0.035803
9,14,23,2578,892307,894885,0.000146,0.019768,0.019914
10,13,23,18365,474308,492673,0.000840,0.010418,0.011258
9,14,23,8202,248737,256939,0.000396,0.005509,0.005905
10,14,24,28839,198677,227516,0.001278,0.004565,0.005843
9,14,23,1801,140288,142089,0.000089,0.003436,0.003525
10,15,25,34258,4184672,4218930,0.001513,0.093627,0.095140
9,14,23,8806,655631,664437,0.000416,0.014956,0.015372
10,13,23,22072,21153,43225,0.001055,0.000574,0.001629
10,15,25,8117,1920726,1928843,0.000373,0.045956,0.046329
9,15,24,2382,3041575,3043957,0.000130,0.066103,0.066233
9,14,23,6325,1174365,1180690,0.000325,0.025302,0.025627
9,14,23,10068,328382,338450,0.000833,0.007409,0.008242
10,14,24,24907,429736,454643,0.002150,0.010985,0.013135
9,14,23,8444,422471,430915,0.000421,0.010412,0.010833
10,15,25,42604,5080858,5123462,0.001818,0.113121,0.114939
9,13,22,8862,205513,214375,0.000407,0.004543,0.004950
9,15,24,1399,671460,672859,0.000067,0.015904,0.015971
10,16,26,107501,3827311,3934812,0.004245,0.093166,0.097411
10,15,25,14815,835611,850426,0.000736,0.019043,0.019779
10,13,23,28317,123154,151471,0.001319,0.003022,0.004341
9,13,22,13259,128731,141990,0.000553,0.003215,0.003768
9,14,23,5647,217929,223576,0.000252,0.005055,0.005307
10,15,25,20328,1348076,1368404,0.000903,0.032528,0.033431
10,15,25,37490,1162778,1200268,0.001669,0.027697,0.029366
10,15,25,24236,1025937,1050173,0.001118,0.022838,0.023956
8,14,22,213,5352877,5353090,0.000010,0.116638,0.116648
10,15,25,6330,1342782,1349112,0.000408,0.037246,0.037654
9,15,24,3548,1293798,1297346,0.000241,0.037909,0.038150
10,13,23,16691,219159,235850,0.000913,0.006399,0.007312
9,14,23,2597,472228,474825,0.000170,0.014231,0.014401
10,15,25,12084,2464591,2476675,0.000661,0.065006,0.065667
10,15,25,22421,950387,972808,0.001080,0.024925,0.026005
9,13,22,3688,556834,560522,0.000285,0.018989,0.019274
10,15,25,48737,558722,607459,0.002605,0.017697,0.020302
10,13,23,16127,38493,54620,0.000902,0.001448,0.002350
10,14,24,27982,39134,67116,0.001485,0.001447,0.002932
10,14,24,33804,828549,862353,0.001738,0.024286,0.026024
10,14,24,16563,81074,97637,0.000899,0.002970,0.003869
10,15,25,24921,1093632,1118553,0.001251,0.030408,0.031659
9,14,23,2596,34155,36751,0.000156,0.001247,0.001403
10,14,24,14840,677698,692538,0.000813,0.019734,0.020547
10,14,24,40859,490312,531171,0.001955,0.014481,0.016436
10,14,24,36580,1470832,1507412,0.002013,0.038816,0.040829
10,14,24,58064,117466,175530,0.002583,0.003873,0.006456
9,15,24,1460,4291071,4292531,0.000090,0.100293,0.100383
10,14,24,47709,790295,838004,0.002196,0.022292,0.024488
9,14,23,5879,160090,165969,0.000328,0.004839,0.005167
10,14,24,20491,1322686,1343177,0.001062,0.033937,0.034999
9,14,23,5027,75239,80266,0.000275,0.001812,0.002087
10,14,24,41766,108642,150408,0.002011,0.003105,0.005116
10,14,24,50405,47046,97451,0.002121,0.001510,0.003631
10,15,25,15575,250790,266365,0.000696,0.006814,0.007510
9,14,23,2987,118470,121457,0.000148,0.003407,0.003555
10,15,25,34133,1171713,1205846,0.001634,0.029828,0.031462
9,14,23,7177,938918,946095,0.000370,0.022715,0.023085
10,15,25,7015,946966,953981,0.000356,0.022506,0.022862
10,14,24,13241,142378,155619,0.000686,0.003529,0.004215
10,14,24,18801,2940378,2959179,0.000937,0.077887,0.078824
10,14,24,14498,276424,290922,0.000742,0.007418,0.008160
9,15,24,7917,1027825,1035742,0.000392,0.028404,0.028796
10,14,24,33302,227745,261047,0.001770,0.006660,0.008430
10,13,23,17454,1715058,1732512,0.001055,0.041578,0.042633
10,15,25,10443,688527,698970,0.000544,0.018412,0.018956
10,15,25,32463,1642525,1674988,0.001404,0.042961,0.044365
9,15,24,2769,972608,975377,0.000158,0.028895,0.029053
9,14,23,1698,425320,427018,0.000097,0.011929,0.012026
9,14,23,17117,93867,110984,0.000770,0.002679,0.003449
9,15,24,3369,1600090,1603459,0.000180,0.048702,0.048882
10,15,25,30110,2411265,2441375,0.001430,0.062948,0.064378
9,15,24,3987,5081971,5085958,0.000215,0.133158,0.133373
10,14,24,29124,474742,503866,0.001494,0.011178,0.012672
10,15,25,16100,1766761,1782861,0.000794,0.044993,0.045787
9,14,23,2513,286748,289261,0.000150,0.008216,0.008366
9,14,23,5470,143799,149269,0.000294,0.003819,0.004113
10,14,24,24455,472245,496700,0.001201,0.012735,0.013936
9,15,24,3813,449291,453104,0.000187,0.013684,0.013871
10,13,23,43693,32592,76285,0.002028,0.000961,0.002989
10,13,23,16746,2201,18947,0.000779,0.000110,0.000889
10,15,25,41247,1143205,1184452,0.002110,0.030278,0.032388
9,15,24,2759,1164126,1166885,0.000151,0.034461,0.034612
9,12,21,2014,2978,4992,0.000117,0.000104,0.000221
10,13,23,27687,2444,30131,0.001324,0.000115,0.001439
10,14,24,34020,944290,978310,0.001308,0.022158,0.023466
9,13,22,3992,28584,32576,0.000217,0.000890,0.001107
10,14,24,29076,397933,427009,0.001278,0.009489,0.010767
9,15,24,4790,1800486,1805276,0.000242,0.043869,0.044111
10,12,22,19752,36766,56518,0.000917,0.000887,0.001804
10,14,24,47072,379187,426259,0.001830,0.011852,0.013682
10,13,23,22529,124359,146888,0.001244,0.003501,0.004745
9,14,23,3333,669917,673250,0.000202,0.024008,0.024210
10,12,22,16603,20523,37126,0.001052,0.000858,0.001910
10,14,24,12328,1212824,1225152,0.000655,0.040114,0.040769
10,14,24,40138,571051,611189,0.002077,0.018166,0.020243
9,13,22,3241,606358,609599,0.000193,0.014428,0.014621
9,14,23,1547,3114901,3116448,0.000096,0.079971,0.080067
10,14,24,14870,867268,882138,0.000680,0.019121,0.019801
10,15,25,35380,303890,339270,0.001559,0.006619,0.008178
9,16,25,2572,1738199,1740771,0.000113,0.038106,0.038219
9,12,21,4203,17249,21452,0.000212,0.000416,0.000628
10,13,23,48683,191443,240126,0.002018,0.004421,0.006439
9,12,21,5300,26528,31828,0.000223,0.000695,0.000918
9,13,22,19806,89803,109609,0.000768,0.002276,0.003044
10,14,24,83625,260030,343655,0.003226,0.006514,0.009740
9,13,22,1307,183445,184752,0.000065,0.004521,0.004586
9,15,24,4513,1165766,1170279,0.000220,0.036547,0.036767
10,14,24,40436,775184,815620,0.002195,0.021438,0.023633
9,13,22,4682,405736,410418,0.000240,0.010964,0.011204
11,16,27,136815,5815298,5952113,0.005725,0.179240,0.184965
10,14,24,27125,74863,101988,0.001329,0.002585,0.003914
9,15,24,2795,2182500,2185295,0.000162,0.052003,0.052165
9,14,23,5912,145139,151051,0.000328,0.004278,0.004606
10,12,22,16146,6300,22446,0.000805,0.000204,0.001009
10,14,24,53790,249469,303259,0.002245,0.006521,0.008766
10,13,23,26708,324557,351265,0.001362,0.008320,0.009682
10,15,25,35762,1142761,1178523,0.001498,0.032503,0.034001
9,12,21,3590,22177,25767,0.000204,0.000635,0.000839
10,15,25,13705,1666623,1680328,0.000659,0.046023,0.046682
10,14,24,65619,2851680,2917299,0.003256,0.064675,0.067931
9,15,24,22361,2202885,2225246,0.001056,0.071543,0.072599
9,14,23,16299,399527,415826,0.000911,0.014388,0.015299
10,14,24,20548,121104,141652,0.001245,0.004440,0.005685
10,15,25,22847,3660581,3683428,0.001306,0.099972,0.101278
10,14,24,7989,2352040,2360029,0.000432,0.071920,0.072352
10,15,25,8849,2311282,2320131,0.000526,0.089801,0.090327
10,12,22,119722,10354,130076,0.007056,0.000470,0.007526
10,10,20,41549,391,41940,0.002142,0.000024,0.002166
9,12,21,5895,53384,59279,0.000329,0.001902,0.002231
10,14,24,10372,128415,138787,0.000694,0.004793,0.005487
10,13,23,50987,55257,106244,0.003269,0.002674,0.005943
10,14,24,13643,4423623,4437266,0.000919,0.158056,0.158975
9,14,23,13580,254151,267731,0.000708,0.007636,0.008344
10,14,24,25767,692592,718359,0.001327,0.023979,0.025306
9,14,23,1442,328890,330332,0.000084,0.010004,0.010088
10,14,24,19703,7526554,7546257,0.001071,0.215850,0.216921
9,14,23,2215,1373323,1375538,0.000191,0.049089,0.049280
10,13,23,24004,126039,150043,0.001360,0.004318,0.005678
10,15,25,56521,574893,631414,0.002597,0.019889,0.022486
9,15,24,2036,461959,463995,0.000139,0.018700,0.018839
10,15,25,11165,1643924,1655089,0.000751,0.052320,0.053071
9,13,22,4277,63956,68233,0.000263,0.002486,0.002749
10,15,25,15776,509441,525217,0.000899,0.017368,0.018267
10,15,25,11540,362364,373904,0.000676,0.011562,0.012238
9,14,23,2751,777949,780700,0.000194,0.024630,0.024824
10,14,24,19170,703404,722574,0.000923,0.020217,0.021140
11,15,26,125444,6060425,6185869,0.005876,0.156683,0.162559
10,14,24,50383,275147,325530,0.002165,0.006867,0.009032
11,14,25,76990,6240,83230,0.004343,0.000448,0.004791
10,15,25,40648,3396173,3436821,0.001884,0.080528,0.082412
9,14,23,2884,276857,279741,0.000145,0.005739,0.005884
9,12,21,10359,39288,49647,0.000503,0.000981,0.001484
9,16,25,1889,3713975,3715864,0.000091,0.137529,0.137620
9,15,24,12407,1573418,1585825,0.000814,0.042187,0.043001
9,15,24,11934,702938,714872,0.000534,0.015024,0.015558
10,13,23,50304,421666,471970,0.001893,0.009656,0.011549
10,14,24,29645,176433,206078,0.001523,0.005102,0.006625
10,15,25,21020,1961659,1982679,0.001158,0.051702,0.052860
9,13,22,10361,133513,143874,0.000542,0.003844,0.004386
10,15,25,37914,462495,500409,0.001850,0.013612,0.015462
10,12,22,15531,57113,72644,0.000832,0.001771,0.002603
10,15,25,16687,363700,380387,0.000912,0.011705,0.012617
9,15,24,3098,4388716,4391814,0.000196,0.128928,0.129124
8,14,22,1525,199839,201364,0.000091,0.005710,0.005801
10,12,22,21391,20757,42148,0.001025,0.000646,0.001671
9,13,22,5331,422944,428275,0.000249,0.015003,0.015252
11,15,26,120252,2166486,2286738,0.006771,0.061227,0.067998
10,14,24,42777,222420,265197,0.002228,0.006652,0.008880
9,14,23,5821,191240,197061,0.000304,0.005443,0.005747
9,14,23,1546,1101086,1102632,0.000082,0.030314,0.030396
8,14,22,1438,2237898,2239336,0.000094,0.065361,0.065455
10,12,22,16537,15997,32534,0.001040,0.000999,0.002039
10,15,25,28356,2105696,2134052,0.001605,0.081002,0.082607
10,15,25,28957,840221,869178,0.001482,0.034671,0.036153
10,13,23,42314,161365,203679,0.002831,0.013165,0.015996
10,13,23,50081,166217,216298,0.003465,0.005722,0.009187
9,13,22,7257,70512,77769,0.000563,0.002565,0.003128
10,15,25,40410,2723223,2763633,0.002445,0.094309,0.096754
11,15,26,277879,396959,674838,0.011290,0.010858,0.022148
10,15,25,8697,1797739,1806436,0.000459,0.051598,0.052057
10,14,24,23849,1292323,1316172,0.001566,0.046457,0.048023
10,13,23,43837,525608,569445,0.002550,0.016623,0.019173
10,15,25,52878,5749839,5802717,0.002904,0.168531,0.171435
10,15,25,6283,824977,831260,0.000383,0.021256,0.021639
10,14,24,11032,862416,873448,0.000655,0.024912,0.025567
9,15,24,1552,3243550,3245102,0.000091,0.079190,0.079281
8,14,22,1446,709885,711331,0.000087,0.017677,0.017764
10,15,25,25204,2493892,2519096,0.001289,0.062120,0.063409
8,12,20,669,103443,104112,0.000045,0.002399,0.002444
10,15,25,32506,1126752,1159258,0.001492,0.026297,0.027789
10,13,23,37949,263870,301819,0.001712,0.005957,0.007669
9,14,23,7677,1777712,1785389,0.000381,0.040665,0.041046
10,15,25,16675,3450700,3467375,0.000739,0.078362,0.079101
9,14,23,7196,377687,384883,0.000297,0.007050,0.007347
9,15,24,13862,2052326,2066188,0.000550,0.038779,0.039329
10,13,23,24671,276829,301500,0.001021,0.005071,0.006092
9,15,24,991,1414386,1415377,0.000045,0.025659,0.025704
9,13,22,4368,163252,167620,0.000189,0.003673,0.003862
10,12,22,7178,39187,46365,0.000325,0.000797,0.001122
10,15,25,13748,1566098,1579846,0.000540,0.036325,0.036865
10,15,25,31493,4024151,4055644,0.001359,0.097527,0.098886
10,13,23,64119,245164,309283,0.002961,0.006006,0.008967
10,14,24,10416,478543,488959,0.000488,0.011218,0.011706
9,11,20,2273,5953,8226,0.000125,0.000188,0.000313
9,14,23,3723,463219,466942,0.000196,0.011201,0.011397
9,15,24,6706,2631586,2638292,0.000339,0.059872,0.060211
9,13,22,5530,933874,939404,0.000281,0.019751,0.020032
10,13,23,35925,184263,220188,0.002555,0.003851,0.006406
8,16,24,806,3627962,3628768,0.000037,0.088367,0.088404
8,14,22,348,105806,106154,0.000021,0.002731,0.002752
8,15,23,404,1648231,1648635,0.000023,0.034736,0.034759
9,14,23,4431,1345651,1350082,0.000239,0.025656,0.025895
9,14,23,25607,592664,618271,0.001249,0.013817,0.015066
9,13,22,2363,128451,130814,0.000209,0.004008,0.004217
10,13,23,20019,63207,83226,0.000871,0.001520,0.002391
10,14,24,51417,270051,321468,0.001844,0.006345,0.008189
10,14,24,21363,1023260,1044623,0.000895,0.023071,0.023966
8,14,22,890,124575,125465,0.000049,0.003068,0.003117
10,15,25,32358,326219,358577,0.001367,0.007893,0.009260
10,14,24,10856,196621,207477,0.000465,0.004786,0.005251
9,15,24,7408,1384512,1391920,0.000357,0.032971,0.033328
10,14,24,17403,986837,1004240,0.000827,0.022669,0.023496
10,15,25,43959,2328905,2372864,0.001959,0.055456,0.057415
8,12,20,1725,82772,84497,0.000092,0.001941,0.002033
9,11,20,11300,21287,32587,0.000522,0.000552,0.001074
9,14,23,6772,1345668,1352440,0.000335,0.044372,0.044707
10,14,24,59476,555866,615342,0.003020,0.016457,0.019477
10,10,20,23260,428,23688,0.001213,0.000020,0.001233
10,15,25,10226,521645,531871,0.000535,0.015314,0.015849
10,14,24,12644,273184,285828,0.000667,0.008778,0.009445
10,14,24,12724,226096,238820,0.000981,0.008314,0.009295
10,15,25,14161,271367,285528,0.000838,0.009489,0.010327
10,15,25,10078,1517923,1528001,0.000631,0.059168,0.059799
8,13,21,276,91773,92049,0.000022,0.003187,0.003209
10,14,24,4535,373898,378433,0.000325,0.013293,0.013618
9,16,25,1801,2379669,2381470,0.000138,0.081848,0.081986
10,14,24,19090,735687,754777,0.001042,0.024043,0.025085
9,15,24,5783,2064490,2070273,0.000361,0.051599,0.051960
10,13,23,12407,303227,315634,0.000632,0.006638,0.007270
10,13,23,16507,28930,45437,0.000742,0.000760,0.001502
9,13,22,8138,173078,181216,0.000346,0.004210,0.004556
10,15,25,22693,2234585,2257278,0.001012,0.049088,0.050100
10,13,23,12163,73962,86125,0.000544,0.001344,0.001888
10,11,21,23516,13770,37286,0.000950,0.000292,0.001242
10,14,24,59340,229851,289191,0.001946,0.004834,0.006780
10,14,24,17168,1330750,1347918,0.000710,0.029518,0.030228
10,15,25,7726,2200670,2208396,0.000367,0.039182,0.039549
9,15,24,6435,1469172,1475607,0.000289,0.026180,0.026469
10,14,24,30402,994514,1024916,0.001194,0.018006,0.019200
10,14,24,38059,1416348,1454407,0.001408,0.025357,0.026765
9,13,22,2907,377339,380246,0.000263,0.006912,0.007175
10,14,24,78616,1373765,1452381,0.002528,0.027598,0.030126
10,15,25,10662,311717,322379,0.000426,0.005349,0.005775
9,15,24,3013,948321,951334,0.000339,0.016354,0.016693
9,13,22,1804,27784,29588,0.000085,0.000523,0.000608
10,16,26,52976,2735174,2788150,0.001860,0.052825,0.054685
10,14,24,52308,61500,113808,0.002113,0.001243,0.003356
10,15,25,9239,876576,885815,0.000325,0.018014,0.018339
10,15,25,25765,504519,530284,0.000998,0.011452,0.012450
9,15,24,10081,307817,317898,0.000459,0.007117,0.007576
9,13,22,1757,62345,64102,0.000085,0.001575,0.001660
9,14,23,12459,602330,614789,0.000485,0.013353,0.013838
10,15,25,15635,1827278,1842913,0.000722,0.034031,0.034753
10,14,24,50047,1408706,1458753,0.001847,0.026430,0.028277
10,15,25,76078,864886,940964,0.002388,0.018935,0.021323
9,15,24,2025,2072852,2074877,0.000094,0.036896,0.036990
9,15,24,11263,1062392,1073655,0.000458,0.018274,0.018732
10,14,24,54685,283034,337719,0.002135,0.005678,0.007813
9,13,22,7344,454349,461693,0.000317,0.009408,0.009725
10,15,25,21078,388474,409552,0.000924,0.009015,0.009939
9,13,22,1562,53031,54593,0.000076,0.001266,0.001342
10,14,24,16162,76419,92581,0.000714,0.001949,0.002663
10,15,25,129808,2475472,2605280,0.004764,0.053270,0.058034
9,15,24,10759,1080571,1091330,0.000407,0.018511,0.018918
10,15,25,15095,1198186,1213281,0.000644,0.029631,0.030275
10,15,25,18467,4940572,4959039,0.000786,0.085974,0.086760
9,12,21,933,20929,21862,0.000050,0.000775,0.000825
10,14,24,14422,208519,222941,0.000633,0.004154,0.004787
10,15,25,11518,1161048,1172566,0.000534,0.021147,0.021681
10,14,24,10222,710251,720473,0.000458,0.013095,0.013553
10,13,23,27081,169203,196284,0.001026,0.003400,0.004426
10,14,24,13044,837420,850464,0.000504,0.015685,0.016189
8,15,23,543,1266568,1267111,0.000024,0.024233,0.024257
9,15,24,11740,1350528,1362268,0.000433,0.023983,0.024416
10,15,25,31863,1291518,1323381,0.001253,0.024204,0.025457
10,14,24,4457,325130,329587,0.000193,0.006102,0.006295
10,15,25,17893,3044764,3062657,0.000731,0.084057,0.084788
10,15,25,62084,357252,419336,0.002666,0.008753,0.011419
9,12,21,2098,26230,28328,0.000104,0.000685,0.000789
9,14,23,12186,1124484,1136670,0.000512,0.025759,0.026271
10,15,25,38322,4053841,4092163,0.001604,0.124465,0.126069
10,14,24,11963,592742,604705,0.000724,0.022185,0.022909
9,13,22,4990,294252,299242,0.000288,0.008362,0.008650
10,15,25,24425,417352,441777,0.001356,0.018099,0.019455
10,15,25,6240,6891622,6897862,0.000381,0.147569,0.147950
10,14,24,56102,774951,831053,0.002845,0.016830,0.019675
9,14,23,3377,4174512,4177889,0.000153,0.078332,0.078485
10,14,24,64539,235708,300247,0.002588,0.004818,0.007406
9,14,23,14121,12851,26972,0.000525,0.000421,0.000946
8,14,22,249,444421,444670,0.000008,0.009307,0.009315
9,13,22,1170,124366,125536,0.000059,0.002935,0.002994
9,14,23,7786,62547,70333,0.000328,0.001570,0.001898
10,14,24,12507,83363,95870,0.000595,0.002167,0.002762
10,11,21,43951,4679,48630,0.001682,0.000164,0.001846
9,14,23,3994,1667496,1671490,0.000176,0.037664,0.037840
9,14,23,9340,1738084,1747424,0.000455,0.035139,0.035594
11,16,27,107175,2896305,3003480,0.003573,0.065696,0.069269
10,14,24,9272,81737,91009,0.000445,0.001786,0.002231
11,14,25,121280,2647277,2768557,0.004849,0.061363,0.066212
9,14,23,3424,169191,172615,0.000191,0.004132,0.004323
10,14,24,11186,128673,139859,0.000536,0.003033,0.003569
9,12,21,3601,46527,50128,0.000183,0.001140,0.001323
9,15,24,1494,605138,606632,0.000080,0.013804,0.013884
9,15,24,5596,952214,957810,0.000290,0.021074,0.021364
10,13,23,36537,189533,226070,0.001518,0.004299,0.005817
11,15,26,141724,2578736,2720460,0.005311,0.058372,0.063683
9,14,23,9147,492965,502112,0.000435,0.008577,0.009012
10,12,22,22309,159441,181750,0.000881,0.002902,0.003783
10,14,24,45308,112076,157384,0.001744,0.002358,0.004102
10,14,24,36146,143286,179432,0.001369,0.003437,0.004806
10,15,25,19107,806497,825604,0.000778,0.018746,0.019524
9,12,21,7495,4939,12434,0.000389,0.000171,0.000560
9,14,23,2408,1633410,1635818,0.000116,0.037540,0.037656
10,15,25,26631,1056964,1083595,0.001127,0.024214,0.025341
9,14,23,1334,417372,418706,0.000076,0.009607,0.009683
9,14,23,4550,479300,483850,0.000241,0.012302,0.012543
9,15,24,2611,3492471,3495082,0.000142,0.082249,0.082391
9,14,23,2184,160238,162422,0.000118,0.004093,0.004211
8,14,22,599,676155,676754,0.000032,0.018514,0.018546
9,12,21,5909,20087,25996,0.000827,0.000934,0.001761
10,15,25,75673,612244,687917,0.003721,0.018796,0.022517
7,15,22,231,730453,730684,0.000014,0.021207,0.021221
10,14,24,38571,591417,629988,0.001910,0.017513,0.019423
10,14,24,86448,62456,148904,0.004083,0.002025,0.006108
10,14,24,17765,288967,306732,0.000798,0.008177,0.008975
9,14,23,5253,1099552,1104805,0.000303,0.028182,0.028485
11,16,27,73096,2776396,2849492,0.003109,0.074560,0.077669
9,14,23,2835,590503,593338,0.000147,0.016804,0.016951
10,12,22,20270,59757,80027,0.001053,0.001658,0.002711
9,14,23,6333,2024250,2030583,0.000291,0.052075,0.052366
9,13,22,1249,214922,216171,0.000085,0.005271,0.005356
9,14,23,12988,318000,330988,0.000647,0.008348,0.008995
9,14,23,3727,767445,771172,0.000195,0.019945,0.020140
10,15,25,6608,727614,734222,0.000324,0.019979,0.020303
9,13,22,1765,3337,5102,0.000099,0.000118,0.000217
9,14,23,857,191029,191886,0.000048,0.004718,0.004766
10,14,24,25698,114545,140243,0.001269,0.003140,0.004409
10,15,25,28558,6483587,6512145,0.001304,0.151877,0.153181
10,15,25,11873,952158,964031,0.000566,0.017466,0.018032
9,15,24,1629,1154358,1155987,0.000082,0.021621,0.021703
10,14,24,17358,193943,211301,0.000765,0.003809,0.004574
10,14,24,13126,82799,95925,0.000519,0.001928,0.002447
10,14,24,80190,103855,184045,0.002782,0.002660,0.005442
9,14,23,2099,605948,608047,0.000080,0.013103,0.013183
10,12,22,37025,764,37789,0.001613,0.000037,0.001650
10,12,22,16553,25154,41707,0.000690,0.000687,0.001377
10,15,25,12705,552203,564908,0.000548,0.013848,0.014396
8,14,22,284,2895374,2895658,0.000016,0.074419,0.074435
10,13,23,15811,27477,43288,0.000704,0.001001,0.001705
10,13,23,6266,285576,291842,0.000294,0.006765,0.007059
10,15,25,75090,3502355,3577445,0.003056,0.072667,0.075723
9,14,23,10796,908733,919529,0.000791,0.019779,0.020570
9,14,23,16074,591641,607715,0.000687,0.015672,0.016359
9,15,24,2259,2165127,2167386,0.000124,0.074565,0.074689
10,14,24,25703,398890,424593,0.001696,0.015905,0.017601
9,12,21,6578,17140,23718,0.000494,0.000852,0.001346
9,14,23,3805,89369,93174,0.000242,0.003951,0.004193
10,13,23,6496,137544,144040,0.000545,0.006035,0.006580
9,16,25,14099,7210972,7225071,0.001047,0.266826,0.267873
10,13,23,55628,56329,111957,0.003155,0.002147,0.005302
10,14,24,35621,871738,907359,0.002032,0.031132,0.033164
9,15,24,8068,1453671,1461739,0.000569,0.066398,0.066967
10,15,25,36118,819306,855424,0.002409,0.032022,0.034431
10,15,25,53649,1641641,1695290,0.003181,0.065536,0.068717
9,13,22,8453,13537,21990,0.000580,0.000791,0.001371
9,15,24,2138,1466258,1468396,0.000171,0.055152,0.055323
10,14,24,29187,290213,319400,0.002030,0.011548,0.013578
10,12,22,87896,35724,123620,0.005543,0.001488,0.007031
9,15,24,10494,1197584,1208078,0.000627,0.044131,0.044758
9,14,23,2657,1101098,1103755,0.000251,0.039521,0.039772
10,15,25,15168,17854789,17869957,0.000988,0.584618,0.585606
9,14,23,2933,1144852,1147785,0.000203,0.032743,0.032946
8,14,22,2523,930996,933519,0.000151,0.026996,0.027147
10,14,24,29450,358189,387639,0.001537,0.011118,0.012655
10,12,22,23467,30130,53597,0.001292,0.000958,0.002250
10,15,25,67671,1600108,1667779,0.002963,0.042436,0.045399
9,13,22,4815,65079,69894,0.000267,0.001786,0.002053
9,15,24,3086,361925,365011,0.000182,0.010891,0.011073
9,16,25,4117,12258784,12262901,0.000236,0.262256,0.262492
9,13,22,2136,165798,167934,0.000132,0.004908,0.005040
10,16,26,84096,4143121,4227217,0.003752,0.131571,0.135323
9,13,22,8454,125719,134173,0.000542,0.004255,0.004797
9,14,23,29530,836589,866119,0.001604,0.025576,0.027180
10,13,23,30596,111994,142590,0.001571,0.003474,0.005045
11,15,26,124787,605457,730244,0.005784,0.019751,0.025535
10,13,23,22693,296104,318797,0.001259,0.008751,0.010010
9,16,25,7150,3456784,3463934,0.000403,0.104811,0.105214
9,14,23,3293,794150,797443,0.000188,0.020533,0.020721
10,15,25,18572,136187,154759,0.000977,0.004046,0.005023
9,13,22,591,4358,4949,0.000031,0.000128,0.000159
10,13,23,18859,3816,22675,0.000825,0.000135,0.000960
9,15,24,13204,9413066,9426270,0.000609,0.259786,0.260395
9,11,20,3848,3324,7172,0.000238,0.000145,0.000383
10,15,25,37047,2298674,2335721,0.001888,0.062492,0.064380
10,14,24,35244,1679247,1714491,0.001586,0.038127,0.039713
10,14,24,33676,285206,318882,0.001557,0.007001,0.008558
11,15,26,103259,2641131,2744390,0.004141,0.062541,0.066682
10,14,24,35658,580713,616371,0.001526,0.011391,0.012917
9,15,24,12812,1368506,1381318,0.000563,0.029189,0.029752
9,14,23,2349,241127,243476,0.000112,0.004734,0.004846
9,12,21,3437,20828,24265,0.000160,0.000407,0.000567
10,15,25,10863,1997955,2008818,0.000427,0.045042,0.045469
10,14,24,52406,864246,916652,0.002335,0.021505,0.023840
10,14,24,18998,687590,706588,0.000907,0.017254,0.018161
9,15,24,6449,1389451,1395900,0.000331,0.031955,0.032286
10,14,24,18622,4814910,4833532,0.000792,0.097766,0.098558
9,14,23,5478,36882,42360,0.000297,0.001048,0.001345
10,12,22,12542,27700,40242,0.000633,0.000985,0.001618
10,14,24,14419,539277,553696,0.000772,0.016983,0.017755
9,14,23,10240,255081,265321,0.000532,0.007467,0.007999
8,15,23,1535,624721,626256,0.000091,0.016586,0.016677
10,13,23,16883,87828,104711,0.000806,0.002466,0.003272
10,14,24,40532,130417,170949,0.001910,0.003656,0.005566
10,15,25,49081,3145323,3194404,0.002166,0.074749,0.076915
11,14,25,111609,831019,942628,0.004100,0.019358,0.023458
10,14,24,16577,3423023,3439600,0.000744,0.069575,0.070319
9,14,23,4623,607897,612520,0.000207,0.012012,0.012219
9,15,24,3208,2367442,2370650,0.000153,0.046137,0.046290
10,15,25,42223,1355222,1397445,0.001748,0.030191,0.031939
8,14,22,4717,686834,691551,0.000448,0.014722,0.015170
10,14,24,25454,34393,59847,0.001167,0.001195,0.002362
10,15,25,12040,1373117,1385157,0.000541,0.033370,0.033911
10,13,23,6251,302608,308859,0.000344,0.007309,0.007653
9,13,22,2021,674573,676594,0.000110,0.015508,0.015618
9,15,24,2431,793598,796029,0.000131,0.020163,0.020294
9,15,24,6894,664212,671106,0.000362,0.017150,0.017512
9,14,23,5176,673734,678910,0.000269,0.015906,0.016175
8,16,24,710,3995321,3996031,0.000040,0.096631,0.096671
10,15,25,10454,1566084,1576538,0.000523,0.038435,0.038958
10,13,23,61234,444052,505286,0.002544,0.010697,0.013241
9,14,23,2848,747098,749946,0.000133,0.017546,0.017679
9,14,23,6495,147347,153842,0.000312,0.003522,0.003834
10,14,24,65188,1115243,1180431,0.002754,0.025361,0.028115
10,13,23,56700,227758,284458,0.002565,0.005858,0.008423
9,15,24,2257,287312,289569,0.000109,0.006862,0.006971
10,15,25,10634,1519615,1530249,0.000485,0.035837,0.036322
11,13,24,63574,75992,139566,0.002859,0.002055,0.004914
8,14,22,306,773042,773348,0.000012,0.017302,0.017314
10,15,25,19745,503187,522932,0.000961,0.013072,0.014033
8,14,22,378,850742,851120,0.000019,0.019953,0.019972
8,14,22,684,750491,751175,0.000040,0.017974,0.018014
10,14,24,31543,162069,193612,0.001495,0.004348,0.005843
10,14,24,27966,352444,380410,0.001293,0.008495,0.009788
8,14,22,241,658652,658893,0.000010,0.016196,0.016206
9,13,22,10660,286667,297327,0.000511,0.007493,0.008004
10,11,21,74568,3293,77861,0.003339,0.000158,0.003497
10,14,24,16974,252721,269695,0.000882,0.007752,0.008634
10,14,24,13855,238500,252355,0.000839,0.007342,0.008181
7,16,23,166,4637847,4638013,0.000008,0.137106,0.137114
9,12,21,10447,50650,61097,0.000543,0.001508,0.002051
7,13,20,149,174349,174498,0.000005,0.005381,0.005386
10,13,23,20811,46120,66931,0.001201,0.001559,0.002760
10,11,21,36053,10908,46961,0.001770,0.000404,0.002174
9,15,24,4117,1129475,1133592,0.000201,0.033442,0.033643
10,15,25,13061,835987,849048,0.000756,0.025838,0.026594
9,14,23,9068,372639,381707,0.000568,0.011399,0.011967
10,15,25,10389,400152,410541,0.000602,0.013327,0.013929
10,14,24,4688,125150,129838,0.000289,0.003915,0.004204
10,14,24,20210,206017,226227,0.001066,0.007015,0.008081
9,12,21,9394,32681,42075,0.000610,0.001157,0.001767
10,13,23,18464,12812,31276,0.001003,0.000542,0.001545
9,15,24,6111,1174607,1180718,0.000328,0.036570,0.036898
10,15,25,32932,311880,344812,0.001659,0.010180,0.011839
9,15,24,8594,671444,680038,0.000572,0.022344,0.022916
10,14,24,31282,541936,573218,0.001725,0.016537,0.018262
10,15,25,42342,2984550,3026892,0.002213,0.089103,0.091316
9,13,22,2334,759692,762026,0.000154,0.019986,0.020140
9,14,23,5664,975705,981369,0.000324,0.025433,0.025757
9,14,23,9538,1284988,1294526,0.000501,0.030312,0.030813
8,15,23,721,3356401,3357122,0.000039,0.079718,0.079757
9,14,23,9695,3065831,3075526,0.000487,0.074531,0.075018
