phase1_solution_length,phase2_solution_length,solution_length,phase1_move_count,phase2_move_count,move_count,phase1_solve_time,phase2_solve_time,solve_time
9,16,25,1800,8098545,8100345,0.000187,0.202900,0.203087
9,14,23,2212,355083,357295,0.000265,0.008643,0.008908
8,15,23,496,3677059,3677555,0.000038,0.092000,0.092038
10,14,24,10144,669359,679503,0.000735,0.017209,0.017944
9,16,25,7188,19996147,20003335,0.000452,0.525071,0.525523
9,15,24,6123,617634,623757,0.000663,0.016863,0.017526
9,14,23,3364,773121,776485,0.000295,0.023562,0.023857
9,15,24,8745,2278270,2287015,0.000680,0.071895,0.072575
10,13,23,17975,33504,51479,0.001225,0.001268,0.002493
10,13,23,35758,62110,97868,0.002133,0.002241,0.004374
10,14,24,51175,8352805,8403980,0.003030,0.228446,0.231476
9,14,23,4705,461097,465802,0.000321,0.011598,0.011919
10,14,24,29344,302806,332150,0.001644,0.008417,0.010061
8,15,23,888,5083196,5084084,0.000060,0.128662,0.128722
10,14,24,77427,394124,471551,0.004007,0.010437,0.014444
9,13,22,7480,41651,49131,0.000438,0.001430,0.001868
10,15,25,53471,888802,942273,0.002775,0.024545,0.027320
10,14,24,14470,2158838,2173308,0.000835,0.053547,0.054382
10,15,25,63587,618742,682329,0.003352,0.017158,0.020510
9,12,21,10404,27168,37572,0.000777,0.000851,0.001628
9,12,21,4306,88224,92530,0.000306,0.002443,0.002749
10,16,26,77063,5802856,5879919,0.004157,0.183319,0.187476
9,11,20,9396,32677,42073,0.000664,0.001059,0.001723
8,15,23,796,1455797,1456593,0.000055,0.044745,0.044800
10,14,24,9916,403292,413208,0.000720,0.012686,0.013406
9,15,24,7886,7106864,7114750,0.000635,0.212188,0.212823
9,15,24,741,1518269,1519010,0.000058,0.037423,0.037481
9,15,24,8176,1506710,1514886,0.000529,0.037589,0.038118
8,14,22,1658,831892,833550,0.000117,0.019978,0.020095
8,13,21,1731,634718,636449,0.000115,0.016142,0.016257
10,15,25,16227,511398,527625,0.001042,0.013345,0.014387
8,13,21,3342,146802,150144,0.000189,0.003918,0.004107
9,13,22,10628,128042,138670,0.000613,0.003601,0.004214
10,15,25,35162,3005828,3040990,0.002258,0.076175,0.078433
9,13,22,6410,137494,143904,0.000440,0.003422,0.003862
10,14,24,45919,1703301,1749220,0.002720,0.042886,0.045606
10,16,26,5056,3812992,3818048,0.000303,0.093743,0.094046
8,13,21,392,109960,110352,0.000028,0.002771,0.002799
10,16,26,12003,4243353,4255356,0.000759,0.106203,0.106962
10,13,23,16254,1096,17350,0.001006,0.000065,0.001071
9,16,25,10752,2653917,2664669,0.000596,0.066438,0.067034
9,13,22,2628,302551,305179,0.000163,0.007558,0.007721
10,15,25,8452,3745260,3753712,0.000544,0.107155,0.107699
9,15,24,1981,1626926,1628907,0.000146,0.041773,0.041919
10,12,22,23487,17444,40931,0.001466,0.000496,0.001962
10,14,24,31816,717516,749332,0.001697,0.020871,0.022568
10,14,24,15546,1278848,1294394,0.000949,0.034848,0.035797
9,15,24,16244,5265963,5282207,0.000935,0.135859,0.136794
10,15,25,9162,548919,558081,0.000730,0.013440,0.014170
9,14,23,7885,319933,327818,0.000507,0.008111,0.008618
9,14,23,3842,1983886,1987728,0.000375,0.047689,0.048064
8,14,22,1136,3434158,3435294,0.000069,0.084272,0.084341
9,15,24,5202,1108941,1114143,0.000353,0.026795,0.027148
9,12,21,8319,82313,90632,0.000570,0.002000,0.002570
9,14,23,2260,239635,241895,0.000150,0.005764,0.005914
10,14,24,7993,986212,994205,0.000679,0.024360,0.025039
10,14,24,7862,712861,720723,0.000492,0.018340,0.018832
9,15,24,1660,4621555,4623215,0.000209,0.112277,0.112486
9,14,23,29222,511292,540514,0.001501,0.012658,0.014159
9,14,23,7050,244398,251448,0.000499,0.006341,0.006840
10,13,23,12653,301389,314042,0.000775,0.007335,0.008110
9,14,23,3396,381204,384600,0.000226,0.009256,0.009482
10,13,23,24232,7861,32093,0.001505,0.000222,0.001727
8,15,23,689,277518,278207,0.000039,0.007596,0.007635
10,16,26,73608,1888382,1961990,0.003561,0.053059,0.056620
10,15,25,23365,2313408,2336773,0.001494,0.055422,0.056916
10,14,24,13045,415921,428966,0.000810,0.010327,0.011137
10,15,25,6856,3311927,3318783,0.000553,0.080002,0.080555
9,14,23,2390,5963197,5965587,0.000153,0.160169,0.160322
9,14,23,6678,1691469,1698147,0.000423,0.046678,0.047101
10,14,24,15626,919200,934826,0.000999,0.023336,0.024335
9,13,22,6098,424800,430898,0.000393,0.011146,0.011539
10,13,23,23228,20143,43371,0.001458,0.000709,0.002167
8,14,22,4321,239919,244240,0.000257,0.006301,0.006558
10,15,25,45605,7898647,7944252,0.002392,0.201616,0.204008
9,15,24,6864,219882,226746,0.000462,0.005549,0.006011
10,14,24,49831,74214,124045,0.002692,0.002327,0.005019
10,13,23,13345,30837,44182,0.000774,0.001067,0.001841
9,15,24,5591,3423950,3429541,0.000307,0.086576,0.086883
9,14,23,9137,2771456,2780593,0.000586,0.065925,0.066511
10,15,25,20889,485233,506122,0.001195,0.013252,0.014447
10,15,25,14133,2952555,2966688,0.000968,0.071611,0.072579
10,13,23,7977,331612,339589,0.000495,0.008567,0.009062
9,14,23,9824,385788,395612,0.000582,0.009477,0.010059
10,13,23,52408,117305,169713,0.002624,0.003177,0.005801
10,14,24,41909,3021085,3062994,0.002107,0.077629,0.079736
9,13,22,8663,39169,47832,0.000511,0.000949,0.001460
9,14,23,2518,960398,962916,0.000144,0.023764,0.023908
10,13,23,107126,341861,448987,0.005244,0.009891,0.015135
9,15,24,1000,379824,380824,0.000062,0.011698,0.011760
10,14,24,36396,3503270,3539666,0.002024,0.088981,0.091005
10,15,25,23777,936059,959836,0.001219,0.024429,0.025648
10,15,25,13601,2854754,2868355,0.000822,0.069930,0.070752
11,14,25,97419,289159,386578,0.004983,0.008185,0.013168
10,15,25,7132,343576,350708,0.000399,0.010619,0.011018
9,15,24,3090,906274,909364,0.000182,0.028578,0.028760
10,14,24,17680,233651,251331,0.001245,0.007835,0.009080
8,14,22,629,1464824,1465453,0.000046,0.038830,0.038876
10,14,24,9265,6035744,6045009,0.000613,0.151588,0.152201
8,14,22,1125,2163595,2164720,0.000070,0.055533,0.055603
9,15,24,1469,5170455,5171924,0.000128,0.128018,0.128146
10,14,24,13411,166575,179986,0.000804,0.004317,0.005121
10,16,26,20383,11521107,11541490,0.001149,0.297575,0.298724
10,13,23,8971,272468,281439,0.000607,0.007412,0.008019
9,15,24,4354,3059837,3064191,0.000296,0.093132,0.093428
10,15,25,5300,1636289,1641589,0.000430,0.051955,0.052385
9,14,23,6586,329882,336468,0.000499,0.010848,0.011347
10,14,24,8297,575378,583675,0.000606,0.018705,0.019311
10,14,24,16218,246976,263194,0.001005,0.008226,0.009231
9,14,23,1888,2253118,2255006,0.000141,0.069584,0.069725
10,12,22,100555,100682,201237,0.005389,0.003517,0.008906
9,13,22,19823,523543,543366,0.001046,0.016890,0.017936
10,15,25,37338,3563359,3600697,0.002342,0.104102,0.106444
9,15,24,3354,868393,871747,0.000251,0.022153,0.022404
9,13,22,956,383471,384427,0.000073,0.009430,0.009503
10,15,25,19608,3130204,3149812,0.001149,0.080652,0.081801
10,14,24,33003,5733866,5766869,0.001906,0.148622,0.150528
10,16,26,7677,6443372,6451049,0.000507,0.161775,0.162282
10,11,21,9796,9018,18814,0.000632,0.000245,0.000877
9,14,23,5613,5624725,5630338,0.000328,0.139616,0.139944
9,13,22,7232,55031,62263,0.000481,0.001349,0.001830
9,14,23,3508,293942,297450,0.000300,0.007474,0.007774
10,15,25,9360,1730853,1740213,0.000973,0.042164,0.043137
10,12,22,21816,23702,45518,0.001325,0.000619,0.001944
9,15,24,4661,4131258,4135919,0.000261,0.104504,0.104765
9,14,23,1932,2113928,2115860,0.000134,0.051390,0.051524
10,13,23,28983,199500,228483,0.001617,0.005051,0.006668
10,14,24,12727,608128,620855,0.000799,0.014812,0.015611
9,14,23,9627,223055,232682,0.001195,0.005420,0.006615
10,14,24,10717,472757,483474,0.000586,0.013384,0.013970
9,15,24,44202,2631806,2676008,0.001938,0.070248,0.072186
10,15,25,13936,6351603,6365539,0.000923,0.180862,0.181785
9,14,23,2480,1451340,1453820,0.000186,0.038468,0.038654
10,14,24,44110,203721,247831,0.002391,0.007224,0.009615
10,13,23,23461,184497,207958,0.002156,0.005693,0.007849
9,14,23,8591,1065740,1074331,0.000498,0.029155,0.029653
10,14,24,24844,1064831,1089675,0.001483,0.028491,0.029974
10,14,24,27841,3949180,3977021,0.001677,0.122689,0.124366
10,15,25,25861,4046075,4071936,0.001630,0.115413,0.117043
9,14,23,8996,168168,177164,0.000799,0.004860,0.005659
9,15,24,1948,2928601,2930549,0.000137,0.075997,0.076134
10,14,24,62253,152295,214548,0.003219,0.004105,0.007324
10,11,21,9001,8444,17445,0.000493,0.000387,0.000880
9,15,24,9724,553750,563474,0.000561,0.015277,0.015838
10,13,23,25439,106953,132392,0.001267,0.002958,0.004225
10,14,24,9858,830555,840413,0.000565,0.021862,0.022427
9,15,24,1771,2953698,2955469,0.000131,0.078848,0.078979
8,13,21,1688,17794,19482,0.000122,0.000959,0.001081
9,13,22,823,350904,351727,0.000065,0.009543,0.009608
10,12,22,35828,14681,50509,0.001859,0.000457,0.002316
8,14,22,1689,5231305,5232994,0.000101,0.136866,0.136967
9,15,24,3727,1657426,1661153,0.000274,0.044808,0.045082
10,16,26,24351,4021189,4045540,0.001625,0.128250,0.129875
10,15,25,13170,1667024,1680194,0.000956,0.050278,0.051234
10,15,25,15892,5546001,5561893,0.001065,0.172044,0.173109
10,14,24,15197,925059,940256,0.001105,0.027991,0.029096
10,14,24,40038,101832,141870,0.002258,0.003552,0.005810
8,14,22,374,2220539,2220913,0.000023,0.064164,0.064187
10,15,25,17571,174979,192550,0.001114,0.004691,0.005805
9,14,23,1284,842605,843889,0.000078,0.022137,0.022215
9,14,23,4968,86459,91427,0.000628,0.002151,0.002779
11,15,26,102475,1417683,1520158,0.004806,0.041293,0.046099
9,15,24,8493,1837798,1846291,0.000467,0.045116,0.045583
10,15,25,11447,2885919,2897366,0.000742,0.076041,0.076783
9,15,24,5238,1548282,1553520,0.000332,0.037826,0.038158
9,14,23,12416,2947703,2960119,0.000687,0.072197,0.072884
9,13,22,696,1602982,1603678,0.000049,0.038857,0.038906
9,15,24,1720,1074967,1076687,0.000118,0.026499,0.026617
9,13,22,4816,20867,25683,0.000334,0.000574,0.000908
10,15,25,46569,3855114,3901683,0.002587,0.096236,0.098823
9,14,23,2629,2931942,2934571,0.000173,0.070342,0.070515
10,13,23,15273,898952,914225,0.000892,0.022096,0.022988
10,15,25,47731,968088,1015819,0.002368,0.023962,0.026330
9,14,23,481,95118,95599,0.000028,0.002411,0.002439
8,15,23,374,742057,742431,0.000021,0.031646,0.031667
10,13,23,25986,60306,86292,0.002805,0.002009,0.004814
8,14,22,225,787278,787503,0.000012,0.021480,0.021492
10,14,24,78587,1274914,1353501,0.003655,0.036416,0.040071
9,15,24,4086,3975484,3979570,0.000259,0.097987,0.098246
10,14,24,28417,123732,152149,0.001651,0.003452,0.005103
10,14,24,24131,801147,825278,0.001341,0.021940,0.023281
10,15,25,160547,181940,342487,0.007228,0.006290,0.013518
10,15,25,33483,1809966,1843449,0.001765,0.053000,0.054765
9,12,21,4073,54562,58635,0.000360,0.001488,0.001848
10,14,24,23720,255004,278724,0.001354,0.007332,0.008686
9,15,24,2275,8028338,8030613,0.000137,0.196741,0.196878
9,14,23,8493,804748,813241,0.000525,0.019704,0.020229
9,14,23,2660,75311,77971,0.000183,0.002354,0.002537
9,13,22,3486,1217269,1220755,0.000228,0.030063,0.030291
10,12,22,32526,104301,136827,0.001911,0.002842,0.004753
9,15,24,2222,1100593,1102815,0.000133,0.027048,0.027181
9,15,24,6422,3556864,3563286,0.000467,0.087279,0.087746
9,14,23,2683,1712416,1715099,0.000150,0.040644,0.040794
9,12,21,3597,13471,17068,0.000224,0.000473,0.000697
10,13,23,40137,218867,259004,0.002061,0.005800,0.007861
9,14,23,5927,548560,554487,0.000333,0.016255,0.016588
10,15,25,74563,536567,611130,0.004100,0.016063,0.020163
9,14,23,2403,562534,564937,0.000154,0.017184,0.017338
9,14,23,15866,2027203,2043069,0.000790,0.051157,0.051947
10,16,26,29162,8072042,8101204,0.001993,0.213349,0.215342
9,14,23,635,1051467,1052102,0.000047,0.028220,0.028267
10,11,21,25057,5844,30901,0.001477,0.000171,0.001648
8,13,21,2563,27544,30107,0.000145,0.000806,0.000951
10,14,24,38694,232662,271356,0.001999,0.006564,0.008563
8,15,23,944,2740218,2741162,0.000053,0.071158,0.071211
8,14,22,346,1301702,1302048,0.000024,0.032944,0.032968
10,15,25,33821,6212330,6246151,0.001914,0.155709,0.157623
10,15,25,10810,695057,705867,0.000726,0.017362,0.018088
10,15,25,11324,774540,785864,0.000684,0.019127,0.019811
9,15,24,1659,2106825,2108484,0.000103,0.051882,0.051985
10,16,26,83018,1893842,1976860,0.004158,0.051346,0.055504
10,14,24,98784,859028,957812,0.004516,0.025373,0.029889
10,16,26,12691,3060191,3072882,0.000615,0.079068,0.079683
10,15,25,10620,860708,871328,0.000653,0.021569,0.022222
10,15,25,13234,3437370,3450604,0.000821,0.085447,0.086268
10,14,24,32678,2513943,2546621,0.001986,0.062022,0.064008
9,12,21,6686,90728,97414,0.000409,0.002261,0.002670
10,14,24,5797,1472715,1478512,0.000384,0.036365,0.036749
10,14,24,16168,167093,183261,0.000931,0.004373,0.005304
10,14,24,21311,2704591,2725902,0.001272,0.067016,0.068288
10,15,25,20632,2727797,2748429,0.001177,0.066187,0.067364
9,15,24,7063,4146697,4153760,0.000497,0.114028,0.114525
10,13,23,7232,426437,433669,0.000473,0.011012,0.011485
10,14,24,5379,80277,85656,0.000351,0.002086,0.002437
9,13,22,4080,44567,48647,0.000255,0.001182,0.001437
10,14,24,17820,9831,27651,0.001463,0.000399,0.001862
10,16,26,34149,20252094,20286243,0.001715,0.508570,0.510285
10,14,24,9103,71596,80699,0.000722,0.002092,0.002814
10,14,24,15763,274836,290599,0.000903,0.007041,0.007944
10,14,24,24246,154226,178472,0.001385,0.004499,0.005884
9,14,23,9446,493661,503107,0.000502,0.014405,0.014907
9,11,20,4424,20794,25218,0.000272,0.000646,0.000918
9,14,23,1810,349676,351486,0.000108,0.010129,0.010237
8,12,20,699,12217,12916,0.000046,0.000483,0.000529
10,16,26,8717,3446075,3454792,0.000557,0.095612,0.096169
9,14,23,7575,149315,156890,0.000580,0.004059,0.004639
10,13,23,40332,442668,483000,0.002365,0.014733,0.017098
10,14,24,20940,33897,54837,0.001376,0.001498,0.002874
9,13,22,17457,110414,127871,0.001067,0.003708,0.004775
10,15,25,58286,1477701,1535987,0.002892,0.049066,0.051958
9,14,23,2244,2078135,2080379,0.000168,0.063243,0.063411
9,14,23,2638,396383,399021,0.000223,0.013019,0.013242
9,14,23,10122,300374,310496,0.000688,0.009842,0.010530
10,15,25,10306,8219940,8230246,0.000749,0.238704,0.239453
10,13,23,59535,244623,304158,0.003071,0.006781,0.009852
10,12,22,10020,57126,67146,0.000604,0.001755,0.002359
8,15,23,310,1478590,1478900,0.000018,0.043745,0.043763
11,14,25,82303,1719538,1801841,0.004325,0.046541,0.050866
9,14,23,1735,548773,550508,0.000126,0.014371,0.014497
9,13,22,2314,16725,19039,0.000140,0.000496,0.000636
10,15,25,8644,733231,741875,0.000538,0.018467,0.019005
10,15,25,15523,330910,346433,0.000847,0.008902,0.009749
10,14,24,22600,815116,837716,0.001275,0.022107,0.023382
9,13,22,12667,102547,115214,0.000885,0.002697,0.003582
10,14,24,18473,1313692,1332165,0.001075,0.034512,0.035587
9,14,23,4556,470543,475099,0.000285,0.012534,0.012819
9,15,24,7644,1474647,1482291,0.000533,0.037667,0.038200
10,13,23,21129,627558,648687,0.001298,0.015410,0.016708
10,14,24,18484,425653,444137,0.001120,0.010610,0.011730
10,11,21,15544,9049,24593,0.000839,0.000285,0.001124
9,12,21,2817,37654,40471,0.000152,0.001266,0.001418
9,15,24,6907,3201828,3208735,0.000352,0.080375,0.080727
9,14,23,8222,484464,492686,0.000435,0.012659,0.013094
10,13,23,11787,42700,54487,0.000861,0.001637,0.002498
10,15,25,81980,11115480,11197460,0.003608,0.276421,0.280029
10,13,23,21221,101658,122879,0.001300,0.002579,0.003879
10,16,26,38068,9015010,9053078,0.001687,0.250272,0.251959
10,13,23,41617,38959,80576,0.002319,0.001159,0.003478
9,13,22,11792,141567,153359,0.000596,0.004266,0.004862
9,14,23,4208,2202358,2206566,0.000223,0.059156,0.059379
9,13,22,10256,38387,48643,0.000784,0.001338,0.002122
9,12,21,9132,62556,71688,0.000558,0.001705,0.002263
10,14,24,12875,2003430,2016305,0.000780,0.056790,0.057570
10,14,24,31134,2393257,2424391,0.001798,0.063759,0.065557
10,16,26,47692,3253267,3300959,0.002754,0.096834,0.099588
10,13,23,73935,1706510,1780445,0.004411,0.054291,0.058702
9,14,23,3572,6207438,6211010,0.000284,0.166380,0.166664
9,14,23,3585,4461857,4465442,0.000241,0.113893,0.114134
11,14,25,97361,517690,615051,0.004950,0.013242,0.018192
10,14,24,26681,207056,233737,0.001585,0.006635,0.008220
11,13,24,79985,162564,242549,0.004130,0.005015,0.009145
10,12,22,17431,95289,112720,0.000987,0.002948,0.003935
9,15,24,11512,939669,951181,0.000617,0.027514,0.028131
10,14,24,10867,270535,281402,0.000680,0.007148,0.007828
10,14,24,30224,315341,345565,0.002020,0.008245,0.010265
11,14,25,159604,456495,616099,0.007133,0.013838,0.020971
10,13,23,19234,85974,105208,0.000980,0.002940,0.003920
10,13,23,16407,37352,53759,0.000956,0.001239,0.002195
9,14,23,10110,1754495,1764605,0.000574,0.047512,0.048086
9,12,21,852,212270,213122,0.000061,0.005376,0.005437
9,14,23,491,2768939,2769430,0.000032,0.072280,0.072312
9,15,24,5020,1371330,1376350,0.000349,0.042585,0.042934
10,14,24,45135,931565,976700,0.002705,0.030343,0.033048
10,14,24,86969,1316733,1403702,0.004672,0.041689,0.046361
10,14,24,28529,3871954,3900483,0.001743,0.112920,0.114663
10,15,25,14377,301592,315969,0.000980,0.010293,0.011273
10,14,24,7462,715207,722669,0.000591,0.022323,0.022914
9,11,20,5520,16560,22080,0.000424,0.000710,0.001134
10,13,23,18664,686827,705491,0.001327,0.022302,0.023629
10,14,24,14144,2974722,2988866,0.000951,0.092848,0.093799
9,13,22,3184,601955,605139,0.000273,0.017033,0.017306
9,14,23,10571,418300,428871,0.000666,0.012069,0.012735
9,14,23,5792,242134,247926,0.000405,0.007414,0.007819
8,13,21,647,681257,681904,0.000051,0.018505,0.018556
9,14,23,6229,2043613,2049842,0.000390,0.049303,0.049693
8,13,21,2524,490005,492529,0.000163,0.011950,0.012113
10,16,26,31434,5461531,5492965,0.001687,0.143154,0.144841
10,14,24,34647,372156,406803,0.002124,0.009219,0.011343
10,13,23,58726,978894,1037620,0.002937,0.028101,0.031038
9,15,24,4038,7360150,7364188,0.000289,0.182854,0.183143
10,13,23,51574,500125,551699,0.002718,0.012910,0.015628
9,14,23,10966,2040677,2051643,0.000596,0.049055,0.049651
8,12,20,490,222709,223199,0.000032,0.005342,0.005374
10,15,25,27267,1616053,1643320,0.001460,0.040427,0.041887
9,15,24,1199,953471,954670,0.000077,0.023888,0.023965
8,15,23,1009,1624481,1625490,0.000059,0.040388,0.040447
10,15,25,10668,543389,554057,0.000678,0.023185,0.023863
10,15,25,10749,2418612,2429361,0.000620,0.067479,0.068099
10,15,25,32577,1902367,1934944,0.001786,0.048635,0.050421
10,13,23,22713,178045,200758,0.001298,0.004824,0.006122
10,15,25,9154,753424,762578,0.000575,0.019959,0.020534
10,15,25,55291,2818394,2873685,0.002890,0.076219,0.079109
10,15,25,47449,1205189,1252638,0.002381,0.033552,0.035933
