phase1_solution_length,phase2_solution_length,solution_length,phase1_move_count,phase2_move_count,move_count,phase1_solve_time,phase2_solve_time,solve_time
12,8,20,22127536,228,22127764,1.271882,0.000018,1.271900
12,8,20,8283401,115,8283516,0.480830,0.000007,0.480837
13,7,20,496397056,94,496397150,27.889868,0.000005,27.889874
15,5,20,-588031839,75,-588031764,686.138000,0.000007,686.138000
11,9,20,4018601,1728,4020329,0.224590,0.000057,0.224647
13,7,20,426353851,98,426353949,24.438688,0.000006,24.438694
12,8,20,3002003,122,3002125,0.175281,0.000008,0.175289
11,8,19,1061127,95,1061222,0.060845,0.000005,0.060850
12,8,20,857368,159,857527,0.052018,0.000007,0.052025
12,7,19,31120387,91,31120478,1.773048,0.000006,1.773054
12,8,20,21604374,101,21604475,1.223697,0.000007,1.223704
11,9,20,695876,382,696258,0.041212,0.000025,0.041237
13,7,20,261446957,119,261447076,14.645470,0.000013,14.645483
12,8,20,40489194,258,40489452,2.291477,0.000019,2.291496
13,7,20,180974032,105,180974137,10.402721,0.000008,10.402729
11,9,20,1301948,1372,1303320,0.077414,0.000078,0.077492
14,6,20,1944436649,86,1944436735,112.976227,0.000006,112.976234
12,8,20,22856361,126,22856487,1.313968,0.000009,1.313977
12,8,20,20313321,109,20313430,1.156562,0.000007,1.156569
9,11,20,10451,917,11368,0.000752,0.000033,0.000785
10,10,20,51005,3865,54870,0.003267,0.000166,0.003433
13,7,20,65867568,140,65867708,3.749310,0.000011,3.749321
9,11,20,9396,26421,35817,0.000636,0.001130,0.001766
11,9,20,1140774,165,1140939,0.065318,0.000012,0.065330
10,10,20,61694,263,61957,0.004019,0.000020,0.004039
11,7,18,2131244,93,2131337,0.123851,0.000006,0.123857
13,7,20,417783853,91,417783944,23.702881,0.000005,23.702887
13,6,19,438269275,82,438269357,24.083513,0.000005,24.083519
9,10,19,16615,590,17205,0.001371,0.000019,0.001390
8,12,20,1748,10554,12302,0.000158,0.000358,0.000516
14,6,20,169284955,77,169285032,9.791207,0.000004,9.791211
9,11,20,14770,884,15654,0.000943,0.000040,0.000983
13,7,20,132124253,89,132124342,7.160555,0.000005,7.160560
12,8,20,13391064,157,13391221,0.800623,0.000014,0.800637
12,8,20,28448733,94,28448827,1.677761,0.000005,1.677766
13,7,20,203170765,131,203170896,11.765097,0.000010,11.765106
13,7,20,43985884,93,43985977,2.478322,0.000005,2.478327
9,11,20,21546,497,22043,0.001240,0.000043,0.001283
12,8,20,20226847,104,20226951,1.149694,0.000007,1.149701
12,8,20,7133669,171,7133840,0.418813,0.000014,0.418827
13,7,20,350073773,96,350073869,19.665482,0.000005,19.665487
14,6,20,352869002,73,352869075,18.792509,0.000003,18.792513
13,7,20,373520429,86,373520515,21.117311,0.000006,21.117317
9,11,20,16696,7515,24211,0.001113,0.000266,0.001379
12,8,20,1749950,110,1750060,0.105880,0.000005,0.105885
14,6,20,43455749,84,43455833,2.518898,0.000005,2.518903
13,6,19,167664759,80,167664839,9.599712,0.000005,9.599717
15,5,20,1273206050,70,1273206120,70.101440,0.000004,70.101448
14,6,20,1267227538,81,1267227619,71.719131,0.000005,71.719139
12,8,20,8134260,384,8134644,0.451591,0.000020,0.451611
12,8,20,3010489,107,3010596,0.175629,0.000005,0.175634
11,9,20,3488897,296,3489193,0.197322,0.000026,0.197348
12,8,20,23439996,544,23440540,1.312196,0.000036,1.312232
12,8,20,50982413,109,50982522,2.878352,0.000007,2.878359
14,6,20,1624569331,79,1624569410,92.131714,0.000004,92.131721
11,9,20,509391,868,510259,0.031643,0.000063,0.031706
13,7,20,54519969,97,54520066,3.102031,0.000006,3.102037
13,7,20,56472494,85,56472579,3.276632,0.000005,3.276637
10,10,20,257751,2920,260671,0.015180,0.000162,0.015342
12,8,20,30255056,257,30255313,1.657385,0.000014,1.657399
12,8,20,27072704,219,27072923,1.534828,0.000016,1.534844
12,8,20,4677476,106,4677582,0.261631,0.000006,0.261637
11,9,20,802296,138,802434,0.049553,0.000009,0.049562
10,10,20,144152,453,144605,0.008078,0.000039,0.008117
14,6,20,95991661,83,95991744,5.348372,0.000004,5.348376
13,7,20,384592958,114,384593072,22.280233,0.000008,22.280241
12,8,20,1903688,132,1903820,0.110646,0.000007,0.110653
11,9,20,522013,270,522283,0.032285,0.000020,0.032305
13,7,20,31265147,99,31265246,1.845701,0.000007,1.845708
10,10,20,89150,603,89753,0.005583,0.000028,0.005611
13,7,20,18423240,98,18423338,1.060027,0.000005,1.060032
11,9,20,2057380,1109,2058489,0.121498,0.000078,0.121576
14,6,20,660507751,108,660507859,38.811760,0.000005,38.811764
9,11,20,53820,15616,69436,0.003612,0.000571,0.004183
11,9,20,340697,643,341340,0.020791,0.000057,0.020848
10,10,20,82551,1385,83936,0.005198,0.000062,0.005260
12,8,20,11807414,109,11807523,0.667280,0.000006,0.667286
13,6,19,36088977,77,36089054,2.122080,0.000005,2.122085
12,8,20,5179432,111,5179543,0.294003,0.000007,0.294010
10,10,20,33029,1643,34672,0.002112,0.000067,0.002179
12,8,20,702704,109,702813,0.041790,0.000006,0.041796
12,8,20,28917192,115,28917307,1.687789,0.000008,1.687797
12,8,20,13413930,128,13414058,0.787106,0.000009,0.787115
12,8,20,2257585,126,2257711,0.117426,0.000006,0.117432
13,7,20,165508737,95,165508832,9.376974,0.000005,9.376979
14,6,20,833237624,81,833237705,47.993073,0.000005,47.993076
10,10,20,126147,192,126339,0.007673,0.000012,0.007685
14,6,20,577359084,87,577359171,265.682373,0.000004,265.682373
12,8,20,12474513,856,12475369,0.713289,0.000051,0.713340
10,10,20,95022,582,95604,0.005738,0.000039,0.005777
13,7,20,249043189,96,249043285,14.312142,0.000007,14.312149
14,5,19,176928473,65,176928538,10.048345,0.000003,10.048347
12,8,20,16814547,103,16814650,0.958662,0.000006,0.958668
13,7,20,191750953,93,191751046,11.184913,0.000007,11.184919
12,8,20,11960130,109,11960239,0.704655,0.000005,0.704660
14,5,19,2063045313,67,2063045380,348.839447,0.000004,348.839447
14,6,20,45783503,80,45783583,2.706633,0.000004,2.706637
10,9,19,46212,123,46335,0.003471,0.000006,0.003477
13,7,20,183513803,95,183513898,10.609268,0.000005,10.609273
11,8,19,4053610,174,4053784,0.231212,0.000014,0.231226
